АМПЛИТУДА	ПАРАМЕТР	ВЫШЕ
АТМОСФЕРНОЕ ДАВЛЕНИЕ	ПАРАМЕТР	ВЫШЕ
ВЛАЖНОСТЬ (НАЛИЧИЕ ВЛАГИ)	ПАРАМЕТР	ВЫШЕ
ВМЕСТИМОСТЬ (ПАРАМЕТР)	ПАРАМЕТР	ВЫШЕ
ВОДНОСТЬ ВОДОЕМА	ПАРАМЕТР	ВЫШЕ
КИСЛОТНОСТЬ (ПОКАЗАТЕЛЬ)	ПАРАМЕТР	ВЫШЕ
КОНЦЕНТРАЦИЯ ВЕЩЕСТВА	ПАРАМЕТР	ВЫШЕ
МАССА (ФИЗИЧЕСКАЯ ВЕЛИЧИНА)	ПАРАМЕТР	ВЫШЕ
ОБЪЕМ (ВЕЛИЧИНА В ДЛИНУ, ШИРИНУ И ВЫСОТУ)	ПАРАМЕТР	ВЫШЕ
ОКТАНОВОЕ ЧИСЛО	ПАРАМЕТР	ВЫШЕ
ОСВЕЩЕННОСТЬ (СТЕПЕНЬ ОСВЕЩЕНИЯ)	ПАРАМЕТР	ВЫШЕ
ПАРАМЕТР	ПАРАМЕТР	ВЫШЕ
ПЛОЩАДЬ (ПАРАМЕТР)	ПАРАМЕТР	ВЫШЕ
ПОСЕЩАЕМОСТЬ	ПАРАМЕТР	ВЫШЕ
ПРОТЯЖЕННОСТЬ	ПАРАМЕТР	ВЫШЕ
РАЗМЕРНОСТЬ, ЧИСЛО ИЗМЕРЕНИЙ	ПАРАМЕТР	ВЫШЕ
СЕЙСМИЧНОСТЬ	ПАРАМЕТР	ВЫШЕ
СКОРОСТЬ ДВИЖЕНИЯ	ПАРАМЕТР	ВЫШЕ
ТАКТОВАЯ ЧАСТОТА	ПАРАМЕТР	ВЫШЕ
ТЕМПЕРАТУРА	ПАРАМЕТР	ВЫШЕ
ТЕХНИЧЕСКИЙ ПОКАЗАТЕЛЬ	ПАРАМЕТР	ВЫШЕ
ТРАФИК СЕТИ	ПАРАМЕТР	ВЫШЕ
УДЕЛЬНЫЙ ПАРАМЕТР	ПАРАМЕТР	ВЫШЕ
ФИЗИЧЕСКАЯ ВЕЛИЧИНА	ПАРАМЕТР	ВЫШЕ
ЦЕНА ТОВАРА, УСЛУГИ	ПАРАМЕТР	ВЫШЕ
АБСТРАКТНЫЙ	СВОЙСТВО, ХАРАКТЕРИСТИКА	ВЫШЕ
АНТИДЕМОКРАТИЧНОСТЬ	СВОЙСТВО, ХАРАКТЕРИСТИКА	ВЫШЕ
БЕЗВКУСНЫЙ, ПРЕСНЫЙ	СВОЙСТВО, ХАРАКТЕРИСТИКА	ВЫШЕ
БЕЗВОДНЫЙ	СВОЙСТВО, ХАРАКТЕРИСТИКА	ВЫШЕ
БЕЗУСЛОВНЫЙ, НЕ ОГРАНИЧЕННЫЙ УСЛОВИЯМИ	СВОЙСТВО, ХАРАКТЕРИСТИКА	ВЫШЕ
БЛИЗОСТЬ В ОТНОШЕНИЯХ	СВОЙСТВО, ХАРАКТЕРИСТИКА	ВЫШЕ
ВАЛЕНТНОСТЬ ХИМИЧЕСКОГО ЭЛЕМЕНТА	СВОЙСТВО, ХАРАКТЕРИСТИКА	ВЫШЕ
ВНЕШНИЙ ОБЛИК	СВОЙСТВО, ХАРАКТЕРИСТИКА	ВЫШЕ
ВНЕШНЯЯ ЧЕРТА	СВОЙСТВО, ХАРАКТЕРИСТИКА	ВЫШЕ
ВОЗРАСТ	СВОЙСТВО, ХАРАКТЕРИСТИКА	ВЫШЕ
ВРЕМЯ, МОМЕНТ ВРЕМЕНИ	СВОЙСТВО, ХАРАКТЕРИСТИКА	ВЫШЕ
ВРЕМЯ, ПРОДОЛЖИТЕЛЬНОСТЬ	СВОЙСТВО, ХАРАКТЕРИСТИКА	ВЫШЕ
ДЕМОКРАТИЧЕСКАЯ ГЛАСНОСТЬ	СВОЙСТВО, ХАРАКТЕРИСТИКА	ВЫШЕ
ДИКИЙ (НЕКУЛЬТИВИРУЕМЫЙ, НЕПРИРУЧЕННЫЙ)	СВОЙСТВО, ХАРАКТЕРИСТИКА	ВЫШЕ
ДРАМАТИЗМ ПРОИЗВЕДЕНИЯ	СВОЙСТВО, ХАРАКТЕРИСТИКА	ВЫШЕ
ЗАПАХ	СВОЙСТВО, ХАРАКТЕРИСТИКА	ВЫШЕ
ИЗБИРАТЕЛЬНОЕ ДЕЙСТВИЕ	СВОЙСТВО, ХАРАКТЕРИСТИКА	ВЫШЕ
ИНДИВИДУАЛЬНЫЙ (ОТНОСЯЩИЙСЯ В ОТДЕЛ-ТИ, К КАЖД.)	СВОЙСТВО, ХАРАКТЕРИСТИКА	ВЫШЕ
ИСХОДНЫЙ	СВОЙСТВО, ХАРАКТЕРИСТИКА	ВЫШЕ
КАЧЕСТВО (СТЕПЕНЬ ЦЕННОСТИ, ПРИГОДНОСТИ)	СВОЙСТВО, ХАРАКТЕРИСТИКА	ВЫШЕ
КОЛИЧЕСТВО, ВЕЛИЧИНА, ЧИСЛО	СВОЙСТВО, ХАРАКТЕРИСТИКА	ВЫШЕ
КОНВЕРТИРУЕМОСТЬ ВАЛЮТЫ	СВОЙСТВО, ХАРАКТЕРИСТИКА	ВЫШЕ
КРЫТЫЙ	СВОЙСТВО, ХАРАКТЕРИСТИКА	ВЫШЕ
КУЛЬТУРНЫЙ (НЕ ДИКИЙ)	СВОЙСТВО, ХАРАКТЕРИСТИКА	ВЫШЕ
МЕДИЦИНСКОЕ ПОКАЗАНИЕ	СВОЙСТВО, ХАРАКТЕРИСТИКА	ВЫШЕ
МЕДИЦИНСКОЕ ПРОТИВОПОКАЗАНИЕ	СВОЙСТВО, ХАРАКТЕРИСТИКА	ВЫШЕ
МЕСТНЫЙ, ЛОКАЛЬНЫЙ	СВОЙСТВО, ХАРАКТЕРИСТИКА	ВЫШЕ
НАДЕЖНОСТЬ ФУНКЦИОНИРОВАНИЯ	СВОЙСТВО, ХАРАКТЕРИСТИКА	ВЫШЕ
НАЛЕТ, ОТТЕНОК	СВОЙСТВО, ХАРАКТЕРИСТИКА	ВЫШЕ
НАМЕК, СЛАБЫЙ ПРИЗНАК	СВОЙСТВО, ХАРАКТЕРИСТИКА	ВЫШЕ
НАПРАВЛЕНИЕ ДЕЯТЕЛЬНОСТИ	СВОЙСТВО, ХАРАКТЕРИСТИКА	ВЫШЕ
НАСЛЕДСТВЕННОСТЬ	СВОЙСТВО, ХАРАКТЕРИСТИКА	ВЫШЕ
НЕВЫРАЗИТЕЛЬНЫЙ	СВОЙСТВО, ХАРАКТЕРИСТИКА	ВЫШЕ
НЕОДУШЕВЛЕННЫЙ	СВОЙСТВО, ХАРАКТЕРИСТИКА	ВЫШЕ
НЕПОСРЕДСТВЕННЫЙ, НЕПОСРЕДСТВЕННО СЛЕДУЮЩИЙ	СВОЙСТВО, ХАРАКТЕРИСТИКА	ВЫШЕ
НЕПРОЧНЫЙ (НЕДОЛГОВЕЧНЫЙ)	СВОЙСТВО, ХАРАКТЕРИСТИКА	ВЫШЕ
НЕСПОСОБНОСТЬ, НЕУМЕНИЕ	СВОЙСТВО, ХАРАКТЕРИСТИКА	ВЫШЕ
НЕУДАЧЛИВЫЙ	СВОЙСТВО, ХАРАКТЕРИСТИКА	ВЫШЕ
ОБЩИЙ, ЕДИНЫЙ ДЛЯ ВСЕХ	СВОЙСТВО, ХАРАКТЕРИСТИКА	ВЫШЕ
ОСТРОСЮЖЕТНЫЙ	СВОЙСТВО, ХАРАКТЕРИСТИКА	ВЫШЕ
ОТДЕЛЬНЫЙ, ОБОСОБЛЕННЫЙ	СВОЙСТВО, ХАРАКТЕРИСТИКА	ВЫШЕ
ОТЛИЧИТЕЛЬНОЕ СВОЙСТВО	СВОЙСТВО, ХАРАКТЕРИСТИКА	ВЫШЕ
ОТПЕЧАТОК, СЛЕД (РЕЗУЛЬТИРУЮЩИЙ ПРИЗНАК)	СВОЙСТВО, ХАРАКТЕРИСТИКА	ВЫШЕ
ОЦЕНКА (МНЕНИЕ)	СВОЙСТВО, ХАРАКТЕРИСТИКА	ВЫШЕ
ПАХУЧИЙ	СВОЙСТВО, ХАРАКТЕРИСТИКА	ВЫШЕ
ПОРЯДОК СЛЕДОВАНИЯ	СВОЙСТВО, ХАРАКТЕРИСТИКА	ВЫШЕ
ПРЕИМУЩЕСТВО, ПРЕВОСХОДСТВО	СВОЙСТВО, ХАРАКТЕРИСТИКА	ВЫШЕ
ПРОСТОЙ, НЕСЛОЖНЫЙ	СВОЙСТВО, ХАРАКТЕРИСТИКА	ВЫШЕ
СВОЙСТВО ЧИСЛА	СВОЙСТВО, ХАРАКТЕРИСТИКА	ВЫШЕ
СВОЙСТВО, ХАРАКТЕРИСТИКА	СВОЙСТВО, ХАРАКТЕРИСТИКА	ВЫШЕ
СИМПТОМ (ВНЕШНИЙ ПРИЗНАК)	СВОЙСТВО, ХАРАКТЕРИСТИКА	ВЫШЕ
СМЕРТНЫЙ, НЕВЕЧНЫЙ	СВОЙСТВО, ХАРАКТЕРИСТИКА	ВЫШЕ
СОВРЕМЕННЫЙ, ТЕПЕРЕШНИЙ	СВОЙСТВО, ХАРАКТЕРИСТИКА	ВЫШЕ
СООТВЕТСТВУЮЩИЙ	СВОЙСТВО, ХАРАКТЕРИСТИКА	ВЫШЕ
СПОСОБНОСТЬ	СВОЙСТВО, ХАРАКТЕРИСТИКА	ВЫШЕ
СПОСОБНОСТЬ, УМЕНИЕ	СВОЙСТВО, ХАРАКТЕРИСТИКА	ВЫШЕ
СПОСОБНЫЙ (ОБЛАДАЮЩИЙ СПОСОБНОСТЯМИ)	СВОЙСТВО, ХАРАКТЕРИСТИКА	ВЫШЕ
СТЕПЕНЬ (СРАВНИТЕЛЬНАЯ ВЕЛИЧИНА)	СВОЙСТВО, ХАРАКТЕРИСТИКА	ВЫШЕ
СТРОЕНИЕ, СТРУКТУРА	СВОЙСТВО, ХАРАКТЕРИСТИКА	ВЫШЕ
ТЕМПЕРАМЕНТ ЧЕЛОВЕКА	СВОЙСТВО, ХАРАКТЕРИСТИКА	ВЫШЕ
ТОРЖЕСТВЕННЫЙ (ВАЖНЫЙ,ВЕЛИЧАВЫЙ,СЕРЬЕЗНЫЙ)	СВОЙСТВО, ХАРАКТЕРИСТИКА	ВЫШЕ
ФИЗИЧЕСКИ СИЛЬНЫЙ	СВОЙСТВО, ХАРАКТЕРИСТИКА	ВЫШЕ
ФИЗИЧЕСКОЕ СВОЙСТВО	СВОЙСТВО, ХАРАКТЕРИСТИКА	ВЫШЕ
ФОРМА, НАРУЖНЫЙ ВИД	СВОЙСТВО, ХАРАКТЕРИСТИКА	ВЫШЕ
ХАРАКТЕРИСТИКА ВЫСКАЗЫВАНИЯ	СВОЙСТВО, ХАРАКТЕРИСТИКА	ВЫШЕ
ХАРАКТЕРИСТИКА ДЕЙСТВИЙ	СВОЙСТВО, ХАРАКТЕРИСТИКА	ВЫШЕ
ХАРАКТЕРИСТИКА ЗВУКА	СВОЙСТВО, ХАРАКТЕРИСТИКА	ВЫШЕ
ХАРАКТЕРИСТИКА ИНФОРМАЦИИ	СВОЙСТВО, ХАРАКТЕРИСТИКА	ВЫШЕ
ХАРАКТЕРИСТИКА МУЗЫКАЛЬНОГО ПРОИЗВЕДЕНИЯ	СВОЙСТВО, ХАРАКТЕРИСТИКА	ВЫШЕ
ХАРАКТЕРИСТИКА ПРОЦЕССА	СВОЙСТВО, ХАРАКТЕРИСТИКА	ВЫШЕ
ЦЕЛОСТНЫЙ	СВОЙСТВО, ХАРАКТЕРИСТИКА	ВЫШЕ
ЧИСТЫЙ, БЕЗ ПРИМЕСЕЙ	СВОЙСТВО, ХАРАКТЕРИСТИКА	ВЫШЕ
ЭКОЛОГИЧНОСТЬ	СВОЙСТВО, ХАРАКТЕРИСТИКА	ВЫШЕ
ВИД ОКРУЖАЮЩЕЙ МЕСТНОСТИ	ВНЕШНИЙ ОБЛИК	ВЫШЕ
ВНЕШНИЙ ОБЛИК	ВНЕШНИЙ ОБЛИК	ВЫШЕ
ВЫРАЖЕНИЕ ЛИЦА	ВНЕШНИЙ ОБЛИК	ВЫШЕ
ГРИМАСА	ВНЕШНИЙ ОБЛИК	ВЫШЕ
ДИЗАЙН (ВНЕШНИЙ ВИД)	ВНЕШНИЙ ОБЛИК	ВЫШЕ
ЗРЕЛИЩЕ (ВИД)	ВНЕШНИЙ ОБЛИК	ВЫШЕ
КАМЕННОЕ ЛИЦО	ВНЕШНИЙ ОБЛИК	ВЫШЕ
МЕСЯЦ (ФАЗА ЛУНЫ)	ВНЕШНИЙ ОБЛИК	ВЫШЕ
НОВОЛУНИЕ (ФАЗА ЛУНЫ)	ВНЕШНИЙ ОБЛИК	ВЫШЕ
ОБСТАНОВКА ПОМЕЩЕНИЯ	ВНЕШНИЙ ОБЛИК	ВЫШЕ
ОКРУЖАЮЩИЙ ПЕЙЗАЖ	ВНЕШНИЙ ОБЛИК	ВЫШЕ
ОФОРМЛЕНИЕ (ВНЕШНИЙ ВИД)	ВНЕШНИЙ ОБЛИК	ВЫШЕ
ПЕРСПЕКТИВА, ПАНОРАМА	ВНЕШНИЙ ОБЛИК	ВЫШЕ
ПОКАЗУХА, БУТАФОРИЯ	ВНЕШНИЙ ОБЛИК	ВЫШЕ
ПОЛНОЛУНИЕ (ФАЗА ЛУНЫ)	ВНЕШНИЙ ОБЛИК	ВЫШЕ
ПРОСТОР, РАЗДОЛЬЕ	ВНЕШНИЙ ОБЛИК	ВЫШЕ
ПРОФИЛЬ ЛИЦА	ВНЕШНИЙ ОБЛИК	ВЫШЕ
СЕРВИРОВКА СТОЛА	ВНЕШНИЙ ОБЛИК	ВЫШЕ
УБРАНСТВО (ВНЕШНИЙ ВИД)	ВНЕШНИЙ ОБЛИК	ВЫШЕ
УЛЫБКА	ВНЕШНИЙ ОБЛИК	ВЫШЕ
УСМЕШКА	ВНЕШНИЙ ОБЛИК	ВЫШЕ
ФАЗА ЛУНЫ	ВНЕШНИЙ ОБЛИК	ВЫШЕ
ЩУРИТЬ ГЛАЗА	ВНЕШНИЙ ОБЛИК	ВЫШЕ
ЭКСТЕРЬЕР ЖИВОТНОГО	ВНЕШНИЙ ОБЛИК	ВЫШЕ
БЛЕКЛЫЙ (БЕСЦВЕТНЫЙ)	ВНЕШНЯЯ ЧЕРТА	ВЫШЕ
БЛЕСТЯЩИЙ (ИМЕЮЩИЙ ЯРКИЙ БЛЕСК)	ВНЕШНЯЯ ЧЕРТА	ВЫШЕ
ВЕСЕЛЫЙ ПО ЦВЕТУ	ВНЕШНЯЯ ЧЕРТА	ВЫШЕ
ВНЕШНЯЯ ЧЕРТА	ВНЕШНЯЯ ЧЕРТА	ВЫШЕ
ВНЯТНЫЙ	ВНЕШНЯЯ ЧЕРТА	ВЫШЕ
ГЛУХОЙ, ГЛУХО ЗВУЧАЩИЙ	ВНЕШНЯЯ ЧЕРТА	ВЫШЕ
ГЛЯНЦЕВЫЙ (БЛЕСТЯЩИЙ)	ВНЕШНЯЯ ЧЕРТА	ВЫШЕ
ГРУБЫЙ ПО ЗВУКУ	ВНЕШНЯЯ ЧЕРТА	ВЫШЕ
ДЛИННОНОГИЙ, С ДЛИННЫМИ НОГАМИ	ВНЕШНЯЯ ЧЕРТА	ВЫШЕ
ЖЕМЧУЖНЫЙ ЦВЕТ	ВНЕШНЯЯ ЧЕРТА	ВЫШЕ
ЖЕНСТВЕННОСТЬ	ВНЕШНЯЯ ЧЕРТА	ВЫШЕ
ЗАПУЩЕННЫЙ, НЕУХОЖЕННЫЙ	ВНЕШНЯЯ ЧЕРТА	ВЫШЕ
ЗЕРКАЛЬНЫЙ (ГЛАДКИЙ И БЛЕСТЯЩИЙ)	ВНЕШНЯЯ ЧЕРТА	ВЫШЕ
КОВАНЫЙ (ЧЕТКИЙ, ВЫРАЗИТЕЛЬНЫЙ)	ВНЕШНЯЯ ЧЕРТА	ВЫШЕ
КОРЕНАСТЫЙ, ПРИЗЕМИСТЫЙ	ВНЕШНЯЯ ЧЕРТА	ВЫШЕ
КРИЧАЩЕ ЯРКИЙ	ВНЕШНЯЯ ЧЕРТА	ВЫШЕ
КУДРЯВЫЙ, КУРЧАВЫЙ	ВНЕШНЯЯ ЧЕРТА	ВЫШЕ
МАТОВЫЙ, НЕГЛЯНЦЕВЫЙ	ВНЕШНЯЯ ЧЕРТА	ВЫШЕ
НЕВНЯТНЫЙ, ПЛОХО СЛЫШИМЫЙ	ВНЕШНЯЯ ЧЕРТА	ВЫШЕ
НЕРАЗБОРЧИВЫЙ	ВНЕШНЯЯ ЧЕРТА	ВЫШЕ
НЕЧЕТКИЙ, НЕОТЧЕТЛИВЫЙ	ВНЕШНЯЯ ЧЕРТА	ВЫШЕ
ОСОБЕННОСТИ ТЕЛОСЛОЖЕНИЯ	ВНЕШНЯЯ ЧЕРТА	ВЫШЕ
ПЕРЕЛИВЧАТЫЙ, С ПЕРЕЛИВАМИ	ВНЕШНЯЯ ЧЕРТА	ВЫШЕ
ПЕРЛАМУТРОВЫЙ ЦВЕТ	ВНЕШНЯЯ ЧЕРТА	ВЫШЕ
ПЛЕЧИСТЫЙ, ШИРОКОПЛЕЧИЙ	ВНЕШНЯЯ ЧЕРТА	ВЫШЕ
ПОДАВЛЕННЫЙ (ПРИГЛУШЕННЫЙ)	ВНЕШНЯЯ ЧЕРТА	ВЫШЕ
ПОМЯТЫЙ (УТОМЛЕННЫЙ)	ВНЕШНЯЯ ЧЕРТА	ВЫШЕ
ПРИГЛУШЕННЫЙ (ТИХИЙ)	ВНЕШНЯЯ ЧЕРТА	ВЫШЕ
РАЗБОРЧИВЫЙ (ОТЧЕТЛИВЫЙ)	ВНЕШНЯЯ ЧЕРТА	ВЫШЕ
РАЗДЕЛЬНЫЙ (ОТЧЕТЛИВЫЙ)	ВНЕШНЯЯ ЧЕРТА	ВЫШЕ
РАСПИСНОЙ (КРАСОЧНЫЙ)	ВНЕШНЯЯ ЧЕРТА	ВЫШЕ
РАСПЛЫВЧАТЫЙ ПО ФОРМЕ	ВНЕШНЯЯ ЧЕРТА	ВЫШЕ
РЕЗКИЙ ПО ЦВЕТУ	ВНЕШНЯЯ ЧЕРТА	ВЫШЕ
РЕЗКОСТЬ ИЗОБРАЖЕНИЯ	ВНЕШНЯЯ ЧЕРТА	ВЫШЕ
РОГАТЫЙ, С РОГАМИ	ВНЕШНЯЯ ЧЕРТА	ВЫШЕ
СМУТНЫЙ (НЕЯСНЫЙ, НЕОТЧЕТЛИВЫЙ)	ВНЕШНЯЯ ЧЕРТА	ВЫШЕ
СОЧНЫЙ ПО ЦВЕТУ	ВНЕШНЯЯ ЧЕРТА	ВЫШЕ
ТОЧЕНЫЙ (ЧЕТКИЙ И КРАСИВЫЙ)	ВНЕШНЯЯ ЧЕРТА	ВЫШЕ
УХОЖЕННЫЙ ВИД	ВНЕШНЯЯ ЧЕРТА	ВЫШЕ
ХОЛЕНЫЙ (УХОЖЕННЫЙ)	ВНЕШНЯЯ ЧЕРТА	ВЫШЕ
ХРИПЛЫЙ	ВНЕШНЯЯ ЧЕРТА	ВЫШЕ
ЦВЕТАСТЫЙ	ВНЕШНЯЯ ЧЕРТА	ВЫШЕ
ЧЕТКИЙ, ЧЕТКО ОЧЕРЧЕННЫЙ	ВНЕШНЯЯ ЧЕРТА	ВЫШЕ
ЯРКИЙ ПО ЦВЕТУ	ВНЕШНЯЯ ЧЕРТА	ВЫШЕ
АВИТАМИНОЗ	КАЧЕСТВО (СТЕПЕНЬ ЦЕННОСТИ, ПРИГОДНОСТИ)	ВЫШЕ
АДЕНОИДЫ	КАЧЕСТВО (СТЕПЕНЬ ЦЕННОСТИ, ПРИГОДНОСТИ)	ВЫШЕ
АСТМА	КАЧЕСТВО (СТЕПЕНЬ ЦЕННОСТИ, ПРИГОДНОСТИ)	ВЫШЕ
БАРОТРАВМА	КАЧЕСТВО (СТЕПЕНЬ ЦЕННОСТИ, ПРИГОДНОСТИ)	ВЫШЕ
БЕДНОСТЬ, НУЖДА	КАЧЕСТВО (СТЕПЕНЬ ЦЕННОСТИ, ПРИГОДНОСТИ)	ВЫШЕ
БЕЗГРАМОТНЫЙ (ОШИБОЧНЫЙ)	КАЧЕСТВО (СТЕПЕНЬ ЦЕННОСТИ, ПРИГОДНОСТИ)	ВЫШЕ
БЕСПЛОДИЕ	КАЧЕСТВО (СТЕПЕНЬ ЦЕННОСТИ, ПРИГОДНОСТИ)	ВЫШЕ
БЕСПОМОЩНЫЙ (ОЧЕНЬ ПЛОХОЙ, СЛАБЫЙ, БЕЗДАРНЫЙ)	КАЧЕСТВО (СТЕПЕНЬ ЦЕННОСТИ, ПРИГОДНОСТИ)	ВЫШЕ
БОГАТЫЙ, НЕБЕДНЫЙ	КАЧЕСТВО (СТЕПЕНЬ ЦЕННОСТИ, ПРИГОДНОСТИ)	ВЫШЕ
БОЛЕЗНИ КОСТНО-МЫШЕЧНОЙ СИСТЕМЫ	КАЧЕСТВО (СТЕПЕНЬ ЦЕННОСТИ, ПРИГОДНОСТИ)	ВЫШЕ
БОЛЕЗНИ КРОВИ	КАЧЕСТВО (СТЕПЕНЬ ЦЕННОСТИ, ПРИГОДНОСТИ)	ВЫШЕ
БОЛЕЗНИ МОЧЕПОЛОВОЙ СИСТЕМЫ	КАЧЕСТВО (СТЕПЕНЬ ЦЕННОСТИ, ПРИГОДНОСТИ)	ВЫШЕ
БОЛЕЗНИ ОРГАНОВ ДЫХАНИЯ	КАЧЕСТВО (СТЕПЕНЬ ЦЕННОСТИ, ПРИГОДНОСТИ)	ВЫШЕ
БОЛЕЗНЬ	КАЧЕСТВО (СТЕПЕНЬ ЦЕННОСТИ, ПРИГОДНОСТИ)	ВЫШЕ
БОЛЕЗНЬ ЖИВОТНОГО	КАЧЕСТВО (СТЕПЕНЬ ЦЕННОСТИ, ПРИГОДНОСТИ)	ВЫШЕ
БОЛЕЗНЬ ИММУННОЙ СИСТЕМЫ	КАЧЕСТВО (СТЕПЕНЬ ЦЕННОСТИ, ПРИГОДНОСТИ)	ВЫШЕ
БОЛЕЗНЬ МОЗГА	КАЧЕСТВО (СТЕПЕНЬ ЦЕННОСТИ, ПРИГОДНОСТИ)	ВЫШЕ
БОЛЕЗНЬ ПЕРЕДВИЖЕНИЯ	КАЧЕСТВО (СТЕПЕНЬ ЦЕННОСТИ, ПРИГОДНОСТИ)	ВЫШЕ
БОЛЕЗНЬ РАСТЕНИЙ	КАЧЕСТВО (СТЕПЕНЬ ЦЕННОСТИ, ПРИГОДНОСТИ)	ВЫШЕ
БРЕШЬ (ПРОЛОМ, ПРОБОИНА)	КАЧЕСТВО (СТЕПЕНЬ ЦЕННОСТИ, ПРИГОДНОСТИ)	ВЫШЕ
ВОЛДЫРЬ НА КОЖЕ	КАЧЕСТВО (СТЕПЕНЬ ЦЕННОСТИ, ПРИГОДНОСТИ)	ВЫШЕ
ВОСПАЛЕНИЕ (БОЛЕЗНЕННЫЙ ПРОЦЕСС)	КАЧЕСТВО (СТЕПЕНЬ ЦЕННОСТИ, ПРИГОДНОСТИ)	ВЫШЕ
ВРАТЬ, ПОКАЗЫВАТЬ НЕВЕРНО	КАЧЕСТВО (СТЕПЕНЬ ЦЕННОСТИ, ПРИГОДНОСТИ)	ВЫШЕ
ВРЕД КУРЕНИЯ	КАЧЕСТВО (СТЕПЕНЬ ЦЕННОСТИ, ПРИГОДНОСТИ)	ВЫШЕ
ВРЕМЕННАЯ НЕТРУДОСПОСОБНОСТЬ	КАЧЕСТВО (СТЕПЕНЬ ЦЕННОСТИ, ПРИГОДНОСТИ)	ВЫШЕ
ВРОЖДЕННОЕ ЗАБОЛЕВАНИЕ	КАЧЕСТВО (СТЕПЕНЬ ЦЕННОСТИ, ПРИГОДНОСТИ)	ВЫШЕ
ВТОРОСОРТНЫЙ	КАЧЕСТВО (СТЕПЕНЬ ЦЕННОСТИ, ПРИГОДНОСТИ)	ВЫШЕ
ВЫБОИНА (ПОВРЕЖДЕНИЕ)	КАЧЕСТВО (СТЕПЕНЬ ЦЕННОСТИ, ПРИГОДНОСТИ)	ВЫШЕ
ВЫКИДЫШ	КАЧЕСТВО (СТЕПЕНЬ ЦЕННОСТИ, ПРИГОДНОСТИ)	ВЫШЕ
ВЫСОКОСОРТНЫЙ	КАЧЕСТВО (СТЕПЕНЬ ЦЕННОСТИ, ПРИГОДНОСТИ)	ВЫШЕ
ГАЛЛЮЦИНАЦИЯ	КАЧЕСТВО (СТЕПЕНЬ ЦЕННОСТИ, ПРИГОДНОСТИ)	ВЫШЕ
ГАНГРЕНА	КАЧЕСТВО (СТЕПЕНЬ ЦЕННОСТИ, ПРИГОДНОСТИ)	ВЫШЕ
ГЕМОРРОЙ	КАЧЕСТВО (СТЕПЕНЬ ЦЕННОСТИ, ПРИГОДНОСТИ)	ВЫШЕ
ГИНЕКОЛОГИЧЕСКАЯ ПАТОЛОГИЯ	КАЧЕСТВО (СТЕПЕНЬ ЦЕННОСТИ, ПРИГОДНОСТИ)	ВЫШЕ
ГЛАЗНАЯ БОЛЕЗНЬ	КАЧЕСТВО (СТЕПЕНЬ ЦЕННОСТИ, ПРИГОДНОСТИ)	ВЫШЕ
ГОЛОВОКРУЖЕНИЕ	КАЧЕСТВО (СТЕПЕНЬ ЦЕННОСТИ, ПРИГОДНОСТИ)	ВЫШЕ
ГРИБКОВОЕ ЗАБОЛЕВАНИЕ	КАЧЕСТВО (СТЕПЕНЬ ЦЕННОСТИ, ПРИГОДНОСТИ)	ВЫШЕ
ГРУБО ОБРАБОТАННЫЙ	КАЧЕСТВО (СТЕПЕНЬ ЦЕННОСТИ, ПРИГОДНОСТИ)	ВЫШЕ
ГРЫЖА	КАЧЕСТВО (СТЕПЕНЬ ЦЕННОСТИ, ПРИГОДНОСТИ)	ВЫШЕ
ДВИГАТЕЛЬ ЗАГЛОХ	КАЧЕСТВО (СТЕПЕНЬ ЦЕННОСТИ, ПРИГОДНОСТИ)	ВЫШЕ
ДЕТСКАЯ БЕЗНАДЗОРНОСТЬ	КАЧЕСТВО (СТЕПЕНЬ ЦЕННОСТИ, ПРИГОДНОСТИ)	ВЫШЕ
ДЕТСКАЯ БОЛЕЗНЬ	КАЧЕСТВО (СТЕПЕНЬ ЦЕННОСТИ, ПРИГОДНОСТИ)	ВЫШЕ
ДЕФЕКТ	КАЧЕСТВО (СТЕПЕНЬ ЦЕННОСТИ, ПРИГОДНОСТИ)	ВЫШЕ
ДИСФУНКЦИЯ ОРГАНОВ	КАЧЕСТВО (СТЕПЕНЬ ЦЕННОСТИ, ПРИГОДНОСТИ)	ВЫШЕ
ДОБРОДЕТЕЛЬ (ПОЛОЖИТЕЛЬНОЕ НРАВСТВЕННОЕ КАЧЕСТВО)	КАЧЕСТВО (СТЕПЕНЬ ЦЕННОСТИ, ПРИГОДНОСТИ)	ВЫШЕ
ДОБРОТНЫЙ	КАЧЕСТВО (СТЕПЕНЬ ЦЕННОСТИ, ПРИГОДНОСТИ)	ВЫШЕ
ДОМОРОЩЕННЫЙ (ПРИМИТИВНЫЙ)	КАЧЕСТВО (СТЕПЕНЬ ЦЕННОСТИ, ПРИГОДНОСТИ)	ВЫШЕ
ДОРОЖНО-ТРАНСПОРТНЫЙ ТРАВМАТИЗМ	КАЧЕСТВО (СТЕПЕНЬ ЦЕННОСТИ, ПРИГОДНОСТИ)	ВЫШЕ
ДОСТОВЕРНОСТЬ ИНФОРМАЦИИ	КАЧЕСТВО (СТЕПЕНЬ ЦЕННОСТИ, ПРИГОДНОСТИ)	ВЫШЕ
ДЫРА (ДЕФЕКТ)	КАЧЕСТВО (СТЕПЕНЬ ЦЕННОСТИ, ПРИГОДНОСТИ)	ВЫШЕ
ЖЕЛУДОЧНО-КИШЕЧНЫЕ ЗАБОЛЕВАНИЯ	КАЧЕСТВО (СТЕПЕНЬ ЦЕННОСТИ, ПРИГОДНОСТИ)	ВЫШЕ
ЖЕНСКАЯ БОЛЕЗНЬ	КАЧЕСТВО (СТЕПЕНЬ ЦЕННОСТИ, ПРИГОДНОСТИ)	ВЫШЕ
ЖИЛИЩНО-БЫТОВЫЕ УСЛОВИЯ	КАЧЕСТВО (СТЕПЕНЬ ЦЕННОСТИ, ПРИГОДНОСТИ)	ВЫШЕ
ЗАБЛУЖДЕНИЕ, ЛОЖНОЕ МНЕНИЕ	КАЧЕСТВО (СТЕПЕНЬ ЦЕННОСТИ, ПРИГОДНОСТИ)	ВЫШЕ
ЗАБОЛЕВАНИЕ ПЕЧЕНИ	КАЧЕСТВО (СТЕПЕНЬ ЦЕННОСТИ, ПРИГОДНОСТИ)	ВЫШЕ
ЗАВИСАНИЕ КОМПЬЮТЕРА	КАЧЕСТВО (СТЕПЕНЬ ЦЕННОСТИ, ПРИГОДНОСТИ)	ВЫШЕ
ЗАКРЫТЫЙ ПЕРЕЛОМ	КАЧЕСТВО (СТЕПЕНЬ ЦЕННОСТИ, ПРИГОДНОСТИ)	ВЫШЕ
ЗАПУЩЕННАЯ ФОРМА ЗАБОЛЕВАНИЯ	КАЧЕСТВО (СТЕПЕНЬ ЦЕННОСТИ, ПРИГОДНОСТИ)	ВЫШЕ
ЗАУРЯДНЫЙ	КАЧЕСТВО (СТЕПЕНЬ ЦЕННОСТИ, ПРИГОДНОСТИ)	ВЫШЕ
ЗАХЛЕБЫВАНИЕ ДВИГАТЕЛЯ	КАЧЕСТВО (СТЕПЕНЬ ЦЕННОСТИ, ПРИГОДНОСТИ)	ВЫШЕ
ЗАЦЕПКА НА ОДЕЖДЕ	КАЧЕСТВО (СТЕПЕНЬ ЦЕННОСТИ, ПРИГОДНОСТИ)	ВЫШЕ
ЗЛОУПОТРЕБЛЕНИЕ, ЧРЕЗМЕРНОЕ ПОТРЕБЛЕНИЕ	КАЧЕСТВО (СТЕПЕНЬ ЦЕННОСТИ, ПРИГОДНОСТИ)	ВЫШЕ
ИЛЛЮЗИЯ, ЖЕЛАЕМОЕ ЗА ДЕЙСТВИТЕЛЬНОЕ	КАЧЕСТВО (СТЕПЕНЬ ЦЕННОСТИ, ПРИГОДНОСТИ)	ВЫШЕ
ИЛЛЮЗИЯ, ОБМАН ЧУВСТВ	КАЧЕСТВО (СТЕПЕНЬ ЦЕННОСТИ, ПРИГОДНОСТИ)	ВЫШЕ
ИМПОТЕНЦИЯ (ПОЛОВОЕ БЕССИЛИЕ)	КАЧЕСТВО (СТЕПЕНЬ ЦЕННОСТИ, ПРИГОДНОСТИ)	ВЫШЕ
ИНВАЛИДНОСТЬ	КАЧЕСТВО (СТЕПЕНЬ ЦЕННОСТИ, ПРИГОДНОСТИ)	ВЫШЕ
ИНФАРКТ	КАЧЕСТВО (СТЕПЕНЬ ЦЕННОСТИ, ПРИГОДНОСТИ)	ВЫШЕ
ИНФЕКЦИОННЫЕ И ПАРАЗИТАРНЫЕ БОЛЕЗНИ	КАЧЕСТВО (СТЕПЕНЬ ЦЕННОСТИ, ПРИГОДНОСТИ)	ВЫШЕ
КАЧЕСТВЕННЫЙ, ВЫСОКОГО КАЧЕСТВА	КАЧЕСТВО (СТЕПЕНЬ ЦЕННОСТИ, ПРИГОДНОСТИ)	ВЫШЕ
КАЧЕСТВО ИНФОРМАЦИИ	КАЧЕСТВО (СТЕПЕНЬ ЦЕННОСТИ, ПРИГОДНОСТИ)	ВЫШЕ
КАЧЕСТВО ПРОДУКЦИИ	КАЧЕСТВО (СТЕПЕНЬ ЦЕННОСТИ, ПРИГОДНОСТИ)	ВЫШЕ
КОЖНАЯ БОЛЕЗНЬ	КАЧЕСТВО (СТЕПЕНЬ ЦЕННОСТИ, ПРИГОДНОСТИ)	ВЫШЕ
КОНДИЦИЯ	КАЧЕСТВО (СТЕПЕНЬ ЦЕННОСТИ, ПРИГОДНОСТИ)	ВЫШЕ
КОНТУЗИЯ	КАЧЕСТВО (СТЕПЕНЬ ЦЕННОСТИ, ПРИГОДНОСТИ)	ВЫШЕ
КРАСОТА, КРАСА	КАЧЕСТВО (СТЕПЕНЬ ЦЕННОСТИ, ПРИГОДНОСТИ)	ВЫШЕ
КРОВОИЗЛИЯНИЕ	КАЧЕСТВО (СТЕПЕНЬ ЦЕННОСТИ, ПРИГОДНОСТИ)	ВЫШЕ
КРОВОТЕЧЕНИЕ	КАЧЕСТВО (СТЕПЕНЬ ЦЕННОСТИ, ПРИГОДНОСТИ)	ВЫШЕ
ЛЕГКОЕ РАНЕНИЕ	КАЧЕСТВО (СТЕПЕНЬ ЦЕННОСТИ, ПРИГОДНОСТИ)	ВЫШЕ
ЛУЧЕВАЯ БОЛЕЗНЬ	КАЧЕСТВО (СТЕПЕНЬ ЦЕННОСТИ, ПРИГОДНОСТИ)	ВЫШЕ
МАТЕРИАЛЬНОЕ ПОЛОЖЕНИЕ	КАЧЕСТВО (СТЕПЕНЬ ЦЕННОСТИ, ПРИГОДНОСТИ)	ВЫШЕ
МИРАЖ (ОПТИЧЕСКАЯ ИЛЛЮЗИЯ)	КАЧЕСТВО (СТЕПЕНЬ ЦЕННОСТИ, ПРИГОДНОСТИ)	ВЫШЕ
МОЗОЛЬ	КАЧЕСТВО (СТЕПЕНЬ ЦЕННОСТИ, ПРИГОДНОСТИ)	ВЫШЕ
НАПОРОТЬСЯ НА ОСТРОЕ	КАЧЕСТВО (СТЕПЕНЬ ЦЕННОСТИ, ПРИГОДНОСТИ)	ВЫШЕ
НАРУШЕНИЕ ЗРЕНИЯ	КАЧЕСТВО (СТЕПЕНЬ ЦЕННОСТИ, ПРИГОДНОСТИ)	ВЫШЕ
НАРУШЕНИЕ ОПОРНО-ДВИГАТЕЛЬНОГО АППАРАТА	КАЧЕСТВО (СТЕПЕНЬ ЦЕННОСТИ, ПРИГОДНОСТИ)	ВЫШЕ
НАРУШЕНИЕ СЛУХА	КАЧЕСТВО (СТЕПЕНЬ ЦЕННОСТИ, ПРИГОДНОСТИ)	ВЫШЕ
НЕВРОЛОГИЧЕСКОЕ ЗАБОЛЕВАНИЕ	КАЧЕСТВО (СТЕПЕНЬ ЦЕННОСТИ, ПРИГОДНОСТИ)	ВЫШЕ
НЕВЫПОЛНЕНИЕ РОДИТЕЛЬСКИХ ОБЯЗАННОСТЕЙ	КАЧЕСТВО (СТЕПЕНЬ ЦЕННОСТИ, ПРИГОДНОСТИ)	ВЫШЕ
НЕДОРАБОТКА, НЕДОДЕЛКА	КАЧЕСТВО (СТЕПЕНЬ ЦЕННОСТИ, ПРИГОДНОСТИ)	ВЫШЕ
НЕДОРАЗУМЕНИЕ (ОШИБОЧНОЕ, НЕПОЛНОЕ ПОНИМАНИЕ)	КАЧЕСТВО (СТЕПЕНЬ ЦЕННОСТИ, ПРИГОДНОСТИ)	ВЫШЕ
НЕДОСМОТР	КАЧЕСТВО (СТЕПЕНЬ ЦЕННОСТИ, ПРИГОДНОСТИ)	ВЫШЕ
НЕДОСТАТОК, НЕПРАВИЛЬНОСТЬ	КАЧЕСТВО (СТЕПЕНЬ ЦЕННОСТИ, ПРИГОДНОСТИ)	ВЫШЕ
НЕДОСТОВЕРНОСТЬ ИНФОРМАЦИИ	КАЧЕСТВО (СТЕПЕНЬ ЦЕННОСТИ, ПРИГОДНОСТИ)	ВЫШЕ
НЕДОЧЕТ, ПРОБЕЛ	КАЧЕСТВО (СТЕПЕНЬ ЦЕННОСТИ, ПРИГОДНОСТИ)	ВЫШЕ
НЕИНФЕКЦИОННОЕ ЗАБОЛЕВАНИЕ	КАЧЕСТВО (СТЕПЕНЬ ЦЕННОСТИ, ПРИГОДНОСТИ)	ВЫШЕ
НЕИСПРАВНОЕ СОСТОЯНИЕ	КАЧЕСТВО (СТЕПЕНЬ ЦЕННОСТИ, ПРИГОДНОСТИ)	ВЫШЕ
НЕКОНДИЦИЯ	КАЧЕСТВО (СТЕПЕНЬ ЦЕННОСТИ, ПРИГОДНОСТИ)	ВЫШЕ
НЕПОЛАДКИ В РАБОТЕ	КАЧЕСТВО (СТЕПЕНЬ ЦЕННОСТИ, ПРИГОДНОСТИ)	ВЫШЕ
НЕСОВЕРШЕННЫЙ	КАЧЕСТВО (СТЕПЕНЬ ЦЕННОСТИ, ПРИГОДНОСТИ)	ВЫШЕ
НИЗКОКАЧЕСТВЕННЫЙ	КАЧЕСТВО (СТЕПЕНЬ ЦЕННОСТИ, ПРИГОДНОСТИ)	ВЫШЕ
НИЗКОСОРТНЫЙ	КАЧЕСТВО (СТЕПЕНЬ ЦЕННОСТИ, ПРИГОДНОСТИ)	ВЫШЕ
НИЩЕТА, КРАЙНЯЯ БЕДНОСТЬ	КАЧЕСТВО (СТЕПЕНЬ ЦЕННОСТИ, ПРИГОДНОСТИ)	ВЫШЕ
ОБМОРОЖЕНИЕ	КАЧЕСТВО (СТЕПЕНЬ ЦЕННОСТИ, ПРИГОДНОСТИ)	ВЫШЕ
ОБОРОТНАЯ СТОРОНА МЕДАЛИ	КАЧЕСТВО (СТЕПЕНЬ ЦЕННОСТИ, ПРИГОДНОСТИ)	ВЫШЕ
ОГОВОРКА В РЕЧИ	КАЧЕСТВО (СТЕПЕНЬ ЦЕННОСТИ, ПРИГОДНОСТИ)	ВЫШЕ
ОДУРЕТЬ, ОБАЛДЕТЬ	КАЧЕСТВО (СТЕПЕНЬ ЦЕННОСТИ, ПРИГОДНОСТИ)	ВЫШЕ
ОЖОГ	КАЧЕСТВО (СТЕПЕНЬ ЦЕННОСТИ, ПРИГОДНОСТИ)	ВЫШЕ
ОНКОЛОГИЧЕСКОЕ ЗАБОЛЕВАНИЕ	КАЧЕСТВО (СТЕПЕНЬ ЦЕННОСТИ, ПРИГОДНОСТИ)	ВЫШЕ
ОПЕЧАТКА	КАЧЕСТВО (СТЕПЕНЬ ЦЕННОСТИ, ПРИГОДНОСТИ)	ВЫШЕ
ОПИСКА	КАЧЕСТВО (СТЕПЕНЬ ЦЕННОСТИ, ПРИГОДНОСТИ)	ВЫШЕ
ОПТИЧЕСКАЯ ИЛЛЮЗИЯ	КАЧЕСТВО (СТЕПЕНЬ ЦЕННОСТИ, ПРИГОДНОСТИ)	ВЫШЕ
ОСКОЛОЧНОЕ РАНЕНИЕ	КАЧЕСТВО (СТЕПЕНЬ ЦЕННОСТИ, ПРИГОДНОСТИ)	ВЫШЕ
ОСПИНА	КАЧЕСТВО (СТЕПЕНЬ ЦЕННОСТИ, ПРИГОДНОСТИ)	ВЫШЕ
ОТКРЫТЫЙ ПЕРЕЛОМ	КАЧЕСТВО (СТЕПЕНЬ ЦЕННОСТИ, ПРИГОДНОСТИ)	ВЫШЕ
ОТРАВЛЕНИЕ ЯДОВИТЫМ ВЕЩЕСТВОМ	КАЧЕСТВО (СТЕПЕНЬ ЦЕННОСТИ, ПРИГОДНОСТИ)	ВЫШЕ
ОТСТАВАНИЕ ЧАСОВ	КАЧЕСТВО (СТЕПЕНЬ ЦЕННОСТИ, ПРИГОДНОСТИ)	ВЫШЕ
ОШИБКА	КАЧЕСТВО (СТЕПЕНЬ ЦЕННОСТИ, ПРИГОДНОСТИ)	ВЫШЕ
ОШИБКА В ТЕКСТЕ	КАЧЕСТВО (СТЕПЕНЬ ЦЕННОСТИ, ПРИГОДНОСТИ)	ВЫШЕ
ОШИБКА ПРИ ПОДСЧЕТЕ	КАЧЕСТВО (СТЕПЕНЬ ЦЕННОСТИ, ПРИГОДНОСТИ)	ВЫШЕ
ПАРАЗИТАРНАЯ БОЛЕЗНЬ	КАЧЕСТВО (СТЕПЕНЬ ЦЕННОСТИ, ПРИГОДНОСТИ)	ВЫШЕ
ПАРАЛИЗОВАТЬ, РАЗБИТЬ ПАРАЛИЧОМ	КАЧЕСТВО (СТЕПЕНЬ ЦЕННОСТИ, ПРИГОДНОСТИ)	ВЫШЕ
ПЕРЕЛОМ КОСТИ	КАЧЕСТВО (СТЕПЕНЬ ЦЕННОСТИ, ПРИГОДНОСТИ)	ВЫШЕ
ПЕРЕОХЛАЖДЕНИЕ ОРГАНИЗМА	КАЧЕСТВО (СТЕПЕНЬ ЦЕННОСТИ, ПРИГОДНОСТИ)	ВЫШЕ
ПЕРИНАТАЛЬНАЯ ПАТОЛОГИЯ	КАЧЕСТВО (СТЕПЕНЬ ЦЕННОСТИ, ПРИГОДНОСТИ)	ВЫШЕ
ПЕРХОТЬ	КАЧЕСТВО (СТЕПЕНЬ ЦЕННОСТИ, ПРИГОДНОСТИ)	ВЫШЕ
ПИЩЕВОЕ ОТРАВЛЕНИЕ	КАЧЕСТВО (СТЕПЕНЬ ЦЕННОСТИ, ПРИГОДНОСТИ)	ВЫШЕ
ПЛАСТИКА ДВИЖЕНИЯ	КАЧЕСТВО (СТЕПЕНЬ ЦЕННОСТИ, ПРИГОДНОСТИ)	ВЫШЕ
ПОВРЕЖДЕНИЕ (НЕДОСТАТОК)	КАЧЕСТВО (СТЕПЕНЬ ЦЕННОСТИ, ПРИГОДНОСТИ)	ВЫШЕ
ПОВРЕЖДЕНИЕ ЗДОРОВЬЯ	КАЧЕСТВО (СТЕПЕНЬ ЦЕННОСТИ, ПРИГОДНОСТИ)	ВЫШЕ
ПОВРЕЖДЕНИЕ НА КОЖЕ	КАЧЕСТВО (СТЕПЕНЬ ЦЕННОСТИ, ПРИГОДНОСТИ)	ВЫШЕ
ПОДРАНИТЬ ЗВЕРЯ, ПТИЦУ	КАЧЕСТВО (СТЕПЕНЬ ЦЕННОСТИ, ПРИГОДНОСТИ)	ВЫШЕ
ПОДСТРЕЛИТЬ	КАЧЕСТВО (СТЕПЕНЬ ЦЕННОСТИ, ПРИГОДНОСТИ)	ВЫШЕ
ПОЛНОЦЕННЫЙ (ПОЛНОСТЬЮ СООТВЕТСТВУЮЩИЙ ТРЕБОВАНИЯМ)	КАЧЕСТВО (СТЕПЕНЬ ЦЕННОСТИ, ПРИГОДНОСТИ)	ВЫШЕ
ПОЛОЖИТЕЛЬНОЕ КАЧЕСТВО	КАЧЕСТВО (СТЕПЕНЬ ЦЕННОСТИ, ПРИГОДНОСТИ)	ВЫШЕ
ПОМАРКА В ТЕКСТЕ	КАЧЕСТВО (СТЕПЕНЬ ЦЕННОСТИ, ПРИГОДНОСТИ)	ВЫШЕ
ПОРАНИТЬСЯ	КАЧЕСТВО (СТЕПЕНЬ ЦЕННОСТИ, ПРИГОДНОСТИ)	ВЫШЕ
ПОРЕЗАТЬ (ПОРАНИТЬ)	КАЧЕСТВО (СТЕПЕНЬ ЦЕННОСТИ, ПРИГОДНОСТИ)	ВЫШЕ
ПОРОК (БОЛЬШОЙ НЕДОСТАТОК)	КАЧЕСТВО (СТЕПЕНЬ ЦЕННОСТИ, ПРИГОДНОСТИ)	ВЫШЕ
ПОРОК ОБЩЕСТВА	КАЧЕСТВО (СТЕПЕНЬ ЦЕННОСТИ, ПРИГОДНОСТИ)	ВЫШЕ
ПОСРЕДСТВЕННЫЙ, СРЕДНИЙ	КАЧЕСТВО (СТЕПЕНЬ ЦЕННОСТИ, ПРИГОДНОСТИ)	ВЫШЕ
ПРЕМИУМ КЛАСС	КАЧЕСТВО (СТЕПЕНЬ ЦЕННОСТИ, ПРИГОДНОСТИ)	ВЫШЕ
ПРОБОИНА	КАЧЕСТВО (СТЕПЕНЬ ЦЕННОСТИ, ПРИГОДНОСТИ)	ВЫШЕ
ПРОИЗВОДСТВЕННЫЙ БРАК	КАЧЕСТВО (СТЕПЕНЬ ЦЕННОСТИ, ПРИГОДНОСТИ)	ВЫШЕ
ПРОЛОМ (ОТВЕРСТИЕ)	КАЧЕСТВО (СТЕПЕНЬ ЦЕННОСТИ, ПРИГОДНОСТИ)	ВЫШЕ
ПРОМАХ, ОПЛОШНОСТЬ	КАЧЕСТВО (СТЕПЕНЬ ЦЕННОСТИ, ПРИГОДНОСТИ)	ВЫШЕ
ПРОРЕХА	КАЧЕСТВО (СТЕПЕНЬ ЦЕННОСТИ, ПРИГОДНОСТИ)	ВЫШЕ
ПРОСТОЙ (НЕ ЛУЧШЕГО КАЧЕСТВА, ГРУБЫЙ ПО ОБРАБОТКЕ)	КАЧЕСТВО (СТЕПЕНЬ ЦЕННОСТИ, ПРИГОДНОСТИ)	ВЫШЕ
ПРОФЕССИОНАЛЬНОЕ ЗАБОЛЕВАНИЕ	КАЧЕСТВО (СТЕПЕНЬ ЦЕННОСТИ, ПРИГОДНОСТИ)	ВЫШЕ
ПРЫЩ	КАЧЕСТВО (СТЕПЕНЬ ЦЕННОСТИ, ПРИГОДНОСТИ)	ВЫШЕ
ПСИХИЧЕСКОЕ ЗАБОЛЕВАНИЕ	КАЧЕСТВО (СТЕПЕНЬ ЦЕННОСТИ, ПРИГОДНОСТИ)	ВЫШЕ
ПЬЯНСТВО	КАЧЕСТВО (СТЕПЕНЬ ЦЕННОСТИ, ПРИГОДНОСТИ)	ВЫШЕ
РАЗДРАЖЕНИЕ НА КОЖЕ	КАЧЕСТВО (СТЕПЕНЬ ЦЕННОСТИ, ПРИГОДНОСТИ)	ВЫШЕ
РАНА (ТЕЛЕСНОЕ ПОВРЕЖДЕНИЕ)	КАЧЕСТВО (СТЕПЕНЬ ЦЕННОСТИ, ПРИГОДНОСТИ)	ВЫШЕ
РАНЕНИЕ, НАНЕСЕНИЕ РАНЫ	КАЧЕСТВО (СТЕПЕНЬ ЦЕННОСТИ, ПРИГОДНОСТИ)	ВЫШЕ
РАССЕЧЬ (ГЛУБОКО ПОРАНИТЬ)	КАЧЕСТВО (СТЕПЕНЬ ЦЕННОСТИ, ПРИГОДНОСТИ)	ВЫШЕ
РАССТРОЙСТВО ФУНКЦИИ	КАЧЕСТВО (СТЕПЕНЬ ЦЕННОСТИ, ПРИГОДНОСТИ)	ВЫШЕ
СБОЙ В РАБОТЕ	КАЧЕСТВО (СТЕПЕНЬ ЦЕННОСТИ, ПРИГОДНОСТИ)	ВЫШЕ
СВИЩ (ИЗЪЯН В ВИДЕ СКВАЖИНЫ)	КАЧЕСТВО (СТЕПЕНЬ ЦЕННОСТИ, ПРИГОДНОСТИ)	ВЫШЕ
СЕРДЕЧНО-СОСУДИСТЫЕ ЗАБОЛЕВАНИЯ	КАЧЕСТВО (СТЕПЕНЬ ЦЕННОСТИ, ПРИГОДНОСТИ)	ВЫШЕ
СЕРЫЙ (ПОСРЕДСТВЕННЫЙ)	КАЧЕСТВО (СТЕПЕНЬ ЦЕННОСТИ, ПРИГОДНОСТИ)	ВЫШЕ
СЛАБЫЙ ПО КАЧЕСТВУ	КАЧЕСТВО (СТЕПЕНЬ ЦЕННОСТИ, ПРИГОДНОСТИ)	ВЫШЕ
СЛОМ, МЕСТО СЛОМА	КАЧЕСТВО (СТЕПЕНЬ ЦЕННОСТИ, ПРИГОДНОСТИ)	ВЫШЕ
СОЦИАЛЬНО-ОПАСНОЕ ЗАБОЛЕВАНИЕ	КАЧЕСТВО (СТЕПЕНЬ ЦЕННОСТИ, ПРИГОДНОСТИ)	ВЫШЕ
ССАДИНА	КАЧЕСТВО (СТЕПЕНЬ ЦЕННОСТИ, ПРИГОДНОСТИ)	ВЫШЕ
СТОМАТОЛОГИЧЕСКОЕ ЗАБОЛЕВАНИЕ	КАЧЕСТВО (СТЕПЕНЬ ЦЕННОСТИ, ПРИГОДНОСТИ)	ВЫШЕ
СТРЕЛКА СПУЩЕННЫХ ПЕТЕЛЬ	КАЧЕСТВО (СТЕПЕНЬ ЦЕННОСТИ, ПРИГОДНОСТИ)	ВЫШЕ
СТРУПЬЯ НА РАНЕ	КАЧЕСТВО (СТЕПЕНЬ ЦЕННОСТИ, ПРИГОДНОСТИ)	ВЫШЕ
СУЧОК ДРЕВЕСИНЫ	КАЧЕСТВО (СТЕПЕНЬ ЦЕННОСТИ, ПРИГОДНОСТИ)	ВЫШЕ
ТЕЛЕСНОЕ ПОВРЕЖДЕНИЕ	КАЧЕСТВО (СТЕПЕНЬ ЦЕННОСТИ, ПРИГОДНОСТИ)	ВЫШЕ
ТЕРЯТЬ СОЗНАНИЕ	КАЧЕСТВО (СТЕПЕНЬ ЦЕННОСТИ, ПРИГОДНОСТИ)	ВЫШЕ
ТЕЧЬ (ДЫРА, ЩЕЛЬ)	КАЧЕСТВО (СТЕПЕНЬ ЦЕННОСТИ, ПРИГОДНОСТИ)	ВЫШЕ
ТОПОРНО ИЗГОТОВЛЕННЫЙ	КАЧЕСТВО (СТЕПЕНЬ ЦЕННОСТИ, ПРИГОДНОСТИ)	ВЫШЕ
ТОШНОТА	КАЧЕСТВО (СТЕПЕНЬ ЦЕННОСТИ, ПРИГОДНОСТИ)	ВЫШЕ
ТРАВИТЬСЯ, ОТРАВИТЬ СЕБЯ	КАЧЕСТВО (СТЕПЕНЬ ЦЕННОСТИ, ПРИГОДНОСТИ)	ВЫШЕ
ТРАВМА	КАЧЕСТВО (СТЕПЕНЬ ЦЕННОСТИ, ПРИГОДНОСТИ)	ВЫШЕ
ТРАВМАТИЧЕСКАЯ АМПУТАЦИЯ	КАЧЕСТВО (СТЕПЕНЬ ЦЕННОСТИ, ПРИГОДНОСТИ)	ВЫШЕ
ТРОМБОЗ	КАЧЕСТВО (СТЕПЕНЬ ЦЕННОСТИ, ПРИГОДНОСТИ)	ВЫШЕ
ТЯЖЕЛОЕ РАНЕНИЕ	КАЧЕСТВО (СТЕПЕНЬ ЦЕННОСТИ, ПРИГОДНОСТИ)	ВЫШЕ
УБЕГАНИЕ ЧАСОВ	КАЧЕСТВО (СТЕПЕНЬ ЦЕННОСТИ, ПРИГОДНОСТИ)	ВЫШЕ
УВЕЧЬЕ	КАЧЕСТВО (СТЕПЕНЬ ЦЕННОСТИ, ПРИГОДНОСТИ)	ВЫШЕ
УГОРЕТЬ, ОТРАВИТЬСЯ УГАРОМ	КАЧЕСТВО (СТЕПЕНЬ ЦЕННОСТИ, ПРИГОДНОСТИ)	ВЫШЕ
УДАР ЭЛЕКТРОТОКОМ	КАЧЕСТВО (СТЕПЕНЬ ЦЕННОСТИ, ПРИГОДНОСТИ)	ВЫШЕ
УКУС, УКУШЕННОЕ МЕСТО	КАЧЕСТВО (СТЕПЕНЬ ЦЕННОСТИ, ПРИГОДНОСТИ)	ВЫШЕ
УПУЩЕНИЕ	КАЧЕСТВО (СТЕПЕНЬ ЦЕННОСТИ, ПРИГОДНОСТИ)	ВЫШЕ
УРОВЕНЬ БЕДНОСТИ	КАЧЕСТВО (СТЕПЕНЬ ЦЕННОСТИ, ПРИГОДНОСТИ)	ВЫШЕ
УРОВЕНЬ ЖИЗНИ	КАЧЕСТВО (СТЕПЕНЬ ЦЕННОСТИ, ПРИГОДНОСТИ)	ВЫШЕ
УСЛОВИЯ ЖИЗНИ	КАЧЕСТВО (СТЕПЕНЬ ЦЕННОСТИ, ПРИГОДНОСТИ)	ВЫШЕ
УХУДШЕНИЕ САМОЧУВСТВИЯ	КАЧЕСТВО (СТЕПЕНЬ ЦЕННОСТИ, ПРИГОДНОСТИ)	ВЫШЕ
УШИБ (МЕСТО)	КАЧЕСТВО (СТЕПЕНЬ ЦЕННОСТИ, ПРИГОДНОСТИ)	ВЫШЕ
УЯЗВИМОЕ МЕСТО	КАЧЕСТВО (СТЕПЕНЬ ЦЕННОСТИ, ПРИГОДНОСТИ)	ВЫШЕ
УЯЗВИМЫЙ (СЛАБЫЙ, ПЛОХОЙ)	КАЧЕСТВО (СТЕПЕНЬ ЦЕННОСТИ, ПРИГОДНОСТИ)	ВЫШЕ
ФАЛЬСТАРТ	КАЧЕСТВО (СТЕПЕНЬ ЦЕННОСТИ, ПРИГОДНОСТИ)	ВЫШЕ
ФИЗИЧЕСКИЙ НЕДОСТАТОК	КАЧЕСТВО (СТЕПЕНЬ ЦЕННОСТИ, ПРИГОДНОСТИ)	ВЫШЕ
ФИНАНСОВОЕ БЛАГОПОЛУЧИЕ	КАЧЕСТВО (СТЕПЕНЬ ЦЕННОСТИ, ПРИГОДНОСТИ)	ВЫШЕ
ФУНКЦИОНАЛЬНАЯ НЕДОСТАТОЧНОСТЬ ОРГАНА	КАЧЕСТВО (СТЕПЕНЬ ЦЕННОСТИ, ПРИГОДНОСТИ)	ВЫШЕ
ХРОМОНОГИЙ	КАЧЕСТВО (СТЕПЕНЬ ЦЕННОСТИ, ПРИГОДНОСТИ)	ВЫШЕ
ХРОНИЧЕСКАЯ БОЛЕЗНЬ	КАЧЕСТВО (СТЕПЕНЬ ЦЕННОСТИ, ПРИГОДНОСТИ)	ВЫШЕ
ЦАРАПИНА НА КОЖЕ	КАЧЕСТВО (СТЕПЕНЬ ЦЕННОСТИ, ПРИГОДНОСТИ)	ВЫШЕ
ЦИНГА	КАЧЕСТВО (СТЕПЕНЬ ЦЕННОСТИ, ПРИГОДНОСТИ)	ВЫШЕ
ЦИСТИТ	КАЧЕСТВО (СТЕПЕНЬ ЦЕННОСТИ, ПРИГОДНОСТИ)	ВЫШЕ
ЧЕРЕПНО-МОЗГОВАЯ ТРАВМА	КАЧЕСТВО (СТЕПЕНЬ ЦЕННОСТИ, ПРИГОДНОСТИ)	ВЫШЕ
ШИШКА НА ТЕЛЕ	КАЧЕСТВО (СТЕПЕНЬ ЦЕННОСТИ, ПРИГОДНОСТИ)	ВЫШЕ
ЩЕРБИНА НА КОЖЕ	КАЧЕСТВО (СТЕПЕНЬ ЦЕННОСТИ, ПРИГОДНОСТИ)	ВЫШЕ
ЭКОЛОГИЧЕСКОЕ КАЧЕСТВО ПРОДУКЦИИ	КАЧЕСТВО (СТЕПЕНЬ ЦЕННОСТИ, ПРИГОДНОСТИ)	ВЫШЕ
ЭНДОКРИННОЕ ЗАБОЛЕВАНИЕ	КАЧЕСТВО (СТЕПЕНЬ ЦЕННОСТИ, ПРИГОДНОСТИ)	ВЫШЕ
ЭРОЗИЯ ЭПИТЕЛИЯ	КАЧЕСТВО (СТЕПЕНЬ ЦЕННОСТИ, ПРИГОДНОСТИ)	ВЫШЕ
КОЛИЧЕСТВО, ВЕЛИЧИНА, ЧИСЛО	КОЛИЧЕСТВО, ВЕЛИЧИНА, ЧИСЛО	ВЫШЕ
АБСОЛЮТНОЕ БОЛЬШИНСТВО	КОЛИЧЕСТВО, ВЕЛИЧИНА, ЧИСЛО	ВЫШЕ
АВАРИЙНОСТЬ (ПОКАЗАТЕЛЬ)	КОЛИЧЕСТВО, ВЕЛИЧИНА, ЧИСЛО	ВЫШЕ
АВИТАМИНОЗ	КОЛИЧЕСТВО, ВЕЛИЧИНА, ЧИСЛО	ВЫШЕ
АВТОМОБИЛЬНАЯ ПРОБКА	КОЛИЧЕСТВО, ВЕЛИЧИНА, ЧИСЛО	ВЫШЕ
АМПЛИТУДА	КОЛИЧЕСТВО, ВЕЛИЧИНА, ЧИСЛО	ВЫШЕ
АРГУМЕНТ ФУНКЦИИ	КОЛИЧЕСТВО, ВЕЛИЧИНА, ЧИСЛО	ВЫШЕ
АРСЕНАЛ (МНОЖЕСТВО ЗАПАСЕННОГО)	КОЛИЧЕСТВО, ВЕЛИЧИНА, ЧИСЛО	ВЫШЕ
АРТЕРИАЛЬНОЕ ДАВЛЕНИЕ	КОЛИЧЕСТВО, ВЕЛИЧИНА, ЧИСЛО	ВЫШЕ
АТМОСФЕРНОЕ ДАВЛЕНИЕ	КОЛИЧЕСТВО, ВЕЛИЧИНА, ЧИСЛО	ВЫШЕ
БАЛАНС (ИТОГОВАЯ СУММА)	КОЛИЧЕСТВО, ВЕЛИЧИНА, ЧИСЛО	ВЫШЕ
БАНКОВСКАЯ СТАВКА	КОЛИЧЕСТВО, ВЕЛИЧИНА, ЧИСЛО	ВЫШЕ
БЕДНОСТЬ, НУЖДА	КОЛИЧЕСТВО, ВЕЛИЧИНА, ЧИСЛО	ВЫШЕ
БЕЗАЛЬТЕРНАТИВНЫЙ	КОЛИЧЕСТВО, ВЕЛИЧИНА, ЧИСЛО	ВЫШЕ
БЕСПРОЦЕНТНЫЙ	КОЛИЧЕСТВО, ВЕЛИЧИНА, ЧИСЛО	ВЫШЕ
БИРЖЕВОЙ КУРС	КОЛИЧЕСТВО, ВЕЛИЧИНА, ЧИСЛО	ВЫШЕ
БОГАТЫЙ (ДОРОГОСТОЯЩИЙ)	КОЛИЧЕСТВО, ВЕЛИЧИНА, ЧИСЛО	ВЫШЕ
БОЛЬШИНСТВО ГОЛОСОВ	КОЛИЧЕСТВО, ВЕЛИЧИНА, ЧИСЛО	ВЫШЕ
БРУТТО	КОЛИЧЕСТВО, ВЕЛИЧИНА, ЧИСЛО	ВЫШЕ
БУРТ (КУЧА)	КОЛИЧЕСТВО, ВЕЛИЧИНА, ЧИСЛО	ВЫШЕ
БУХГАЛТЕРСКИЙ БАЛАНС	КОЛИЧЕСТВО, ВЕЛИЧИНА, ЧИСЛО	ВЫШЕ
БЫСТРОДЕЙСТВИЕ (ПОКАЗАТЕЛЬ)	КОЛИЧЕСТВО, ВЕЛИЧИНА, ЧИСЛО	ВЫШЕ
БЮДЖЕТНЫЙ ДЕФИЦИТ	КОЛИЧЕСТВО, ВЕЛИЧИНА, ЧИСЛО	ВЫШЕ
ВАЛОВОЙ ПОКАЗАТЕЛЬ	КОЛИЧЕСТВО, ВЕЛИЧИНА, ЧИСЛО	ВЫШЕ
ВЕСОВАЯ КАТЕГОРИЯ СПОРТСМЕНА	КОЛИЧЕСТВО, ВЕЛИЧИНА, ЧИСЛО	ВЫШЕ
ВЛАЖНОСТЬ (НАЛИЧИЕ ВЛАГИ)	КОЛИЧЕСТВО, ВЕЛИЧИНА, ЧИСЛО	ВЫШЕ
ВМЕСТИМОСТЬ (ПАРАМЕТР)	КОЛИЧЕСТВО, ВЕЛИЧИНА, ЧИСЛО	ВЫШЕ
ВОДНОСТЬ ВОДОЕМА	КОЛИЧЕСТВО, ВЕЛИЧИНА, ЧИСЛО	ВЫШЕ
ВОДОИЗМЕЩЕНИЕ	КОЛИЧЕСТВО, ВЕЛИЧИНА, ЧИСЛО	ВЫШЕ
ВОЛАТИЛЬНОСТЬ ЦЕН	КОЛИЧЕСТВО, ВЕЛИЧИНА, ЧИСЛО	ВЫШЕ
ВОРОХ (БОЛЬШОЕ КОЛИЧЕСТВО)	КОЛИЧЕСТВО, ВЕЛИЧИНА, ЧИСЛО	ВЫШЕ
ВОРОХ (ГРУДА)	КОЛИЧЕСТВО, ВЕЛИЧИНА, ЧИСЛО	ВЫШЕ
ВРАТЬ, ПОКАЗЫВАТЬ НЕВЕРНО	КОЛИЧЕСТВО, ВЕЛИЧИНА, ЧИСЛО	ВЫШЕ
ВЫСОКОЕ НАПРЯЖЕНИЕ	КОЛИЧЕСТВО, ВЕЛИЧИНА, ЧИСЛО	ВЫШЕ
ВЫСОТА (ЛИНЕЙНЫЙ РАЗМЕР)	КОЛИЧЕСТВО, ВЕЛИЧИНА, ЧИСЛО	ВЫШЕ
ВЫСОТА (РАССТОЯНИЕ)	КОЛИЧЕСТВО, ВЕЛИЧИНА, ЧИСЛО	ВЫШЕ
ГАБАРИТ (ПРОТЯЖЕННОСТЬ)	КОЛИЧЕСТВО, ВЕЛИЧИНА, ЧИСЛО	ВЫШЕ
ГАЛАКТИКА	КОЛИЧЕСТВО, ВЕЛИЧИНА, ЧИСЛО	ВЫШЕ
ГИПОКСИЯ	КОЛИЧЕСТВО, ВЕЛИЧИНА, ЧИСЛО	ВЫШЕ
ГЛУБИНА (РАССТОЯНИЕ)	КОЛИЧЕСТВО, ВЕЛИЧИНА, ЧИСЛО	ВЫШЕ
ГОЛОВЫ (КОЛИЧЕСТВО)	КОЛИЧЕСТВО, ВЕЛИЧИНА, ЧИСЛО	ВЫШЕ
ГРУЗООБОРОТ	КОЛИЧЕСТВО, ВЕЛИЧИНА, ЧИСЛО	ВЫШЕ
ГРУЗОПОДЪЕМНОСТЬ	КОЛИЧЕСТВО, ВЕЛИЧИНА, ЧИСЛО	ВЫШЕ
ДАВЛЕНИЕ (ФИЗИЧЕСКАЯ ВЕЛИЧИНА)	КОЛИЧЕСТВО, ВЕЛИЧИНА, ЧИСЛО	ВЫШЕ
ДАЛЬНОСТЬ, ПРЕДЕЛЬНОЕ РАССТОЯНИЕ	КОЛИЧЕСТВО, ВЕЛИЧИНА, ЧИСЛО	ВЫШЕ
ДВИЖЕНИЕ РАБОЧЕЙ СИЛЫ	КОЛИЧЕСТВО, ВЕЛИЧИНА, ЧИСЛО	ВЫШЕ
ДВУХМЕРНЫЙ	КОЛИЧЕСТВО, ВЕЛИЧИНА, ЧИСЛО	ВЫШЕ
ДЕБИТ	КОЛИЧЕСТВО, ВЕЛИЧИНА, ЧИСЛО	ВЫШЕ
ДЕФИЦИТ ДЕНЕЖНЫХ СРЕДСТВ	КОЛИЧЕСТВО, ВЕЛИЧИНА, ЧИСЛО	ВЫШЕ
ДЕШЕВЫЙ ПО ЦЕНЕ	КОЛИЧЕСТВО, ВЕЛИЧИНА, ЧИСЛО	ВЫШЕ
ДИАМЕТР	КОЛИЧЕСТВО, ВЕЛИЧИНА, ЧИСЛО	ВЫШЕ
ДЛИНА	КОЛИЧЕСТВО, ВЕЛИЧИНА, ЧИСЛО	ВЫШЕ
ДОЖДЬ, МНОЖЕСТВО ПАДАЮЩЕГО	КОЛИЧЕСТВО, ВЕЛИЧИНА, ЧИСЛО	ВЫШЕ
ДОЗА	КОЛИЧЕСТВО, ВЕЛИЧИНА, ЧИСЛО	ВЫШЕ
ДОЗА ОБЛУЧЕНИЯ	КОЛИЧЕСТВО, ВЕЛИЧИНА, ЧИСЛО	ВЫШЕ
ДОРОГОЙ ПО ЦЕНЕ	КОЛИЧЕСТВО, ВЕЛИЧИНА, ЧИСЛО	ВЫШЕ
ДОХОД	КОЛИЧЕСТВО, ВЕЛИЧИНА, ЧИСЛО	ВЫШЕ
ДРАГОЦЕННЫЙ (ОЧЕНЬ ЦЕННЫЙ)	КОЛИЧЕСТВО, ВЕЛИЧИНА, ЧИСЛО	ВЫШЕ
ЕДИНОВРЕМЕННЫЙ	КОЛИЧЕСТВО, ВЕЛИЧИНА, ЧИСЛО	ВЫШЕ
ЕДИНСТВЕННЫЙ (ТОЛЬКО ОДИН)	КОЛИЧЕСТВО, ВЕЛИЧИНА, ЧИСЛО	ВЫШЕ
ЖИВОЙ ВЕС ЖИВОТНОГО	КОЛИЧЕСТВО, ВЕЛИЧИНА, ЧИСЛО	ВЫШЕ
ЖИРНОСТЬ (ПИЩЕВАЯ ЦЕННОСТЬ)	КОЛИЧЕСТВО, ВЕЛИЧИНА, ЧИСЛО	ВЫШЕ
ЖИРНОСТЬ ЛИНИИ	КОЛИЧЕСТВО, ВЕЛИЧИНА, ЧИСЛО	ВЫШЕ
ЗАВАЛ (ПРЕГРАДА)	КОЛИЧЕСТВО, ВЕЛИЧИНА, ЧИСЛО	ВЫШЕ
ЗАТОР	КОЛИЧЕСТВО, ВЕЛИЧИНА, ЧИСЛО	ВЫШЕ
ИЗБЫТОЧНАЯ МАССА ТЕЛА	КОЛИЧЕСТВО, ВЕЛИЧИНА, ЧИСЛО	ВЫШЕ
ИМПУЛЬС (ФИЗИЧЕСКАЯ ВЕЛИЧИНА)	КОЛИЧЕСТВО, ВЕЛИЧИНА, ЧИСЛО	ВЫШЕ
ИНДЕКС (ПОКАЗАТЕЛЬ)	КОЛИЧЕСТВО, ВЕЛИЧИНА, ЧИСЛО	ВЫШЕ
ИНФОРМАЦИОННАЯ ЭНТРОПИЯ	КОЛИЧЕСТВО, ВЕЛИЧИНА, ЧИСЛО	ВЫШЕ
ИТОГ РАСЧЕТОВ	КОЛИЧЕСТВО, ВЕЛИЧИНА, ЧИСЛО	ВЫШЕ
КАЛИБР СТВОЛА	КОЛИЧЕСТВО, ВЕЛИЧИНА, ЧИСЛО	ВЫШЕ
КАЛОРИЙНОСТЬ ЕДЫ	КОЛИЧЕСТВО, ВЕЛИЧИНА, ЧИСЛО	ВЫШЕ
КВАДРАТ ЧИСЛА	КОЛИЧЕСТВО, ВЕЛИЧИНА, ЧИСЛО	ВЫШЕ
КВАЛИФИЦИРОВАННОЕ БОЛЬШИНСТВО	КОЛИЧЕСТВО, ВЕЛИЧИНА, ЧИСЛО	ВЫШЕ
КВОТА	КОЛИЧЕСТВО, ВЕЛИЧИНА, ЧИСЛО	ВЫШЕ
КИСЛОТНОСТЬ (ПОКАЗАТЕЛЬ)	КОЛИЧЕСТВО, ВЕЛИЧИНА, ЧИСЛО	ВЫШЕ
КОЛЕСНАЯ БАЗА	КОЛИЧЕСТВО, ВЕЛИЧИНА, ЧИСЛО	ВЫШЕ
КОЛИЧЕСТВЕННЫЕ ДАННЫЕ	КОЛИЧЕСТВО, ВЕЛИЧИНА, ЧИСЛО	ВЫШЕ
КОЛИЧЕСТВЕННЫЙ ПАРАМЕТР	КОЛИЧЕСТВО, ВЕЛИЧИНА, ЧИСЛО	ВЫШЕ
КОЛИЧЕСТВО ГОЛОСОВ	КОЛИЧЕСТВО, ВЕЛИЧИНА, ЧИСЛО	ВЫШЕ
КОНКУРЕНТОСПОСОБНОСТЬ	КОЛИЧЕСТВО, ВЕЛИЧИНА, ЧИСЛО	ВЫШЕ
КОНСТАНТА	КОЛИЧЕСТВО, ВЕЛИЧИНА, ЧИСЛО	ВЫШЕ
КОНТАКТНЫЙ НОМЕР	КОЛИЧЕСТВО, ВЕЛИЧИНА, ЧИСЛО	ВЫШЕ
КОНЦЕНТРАЦИЯ ВЕЩЕСТВА	КОЛИЧЕСТВО, ВЕЛИЧИНА, ЧИСЛО	ВЫШЕ
КОРЗИНА (ИНДЕКС)	КОЛИЧЕСТВО, ВЕЛИЧИНА, ЧИСЛО	ВЫШЕ
КОЭФФИЦИЕНТ ПОЛЕЗНОГО ДЕЙСТВИЯ	КОЛИЧЕСТВО, ВЕЛИЧИНА, ЧИСЛО	ВЫШЕ
КРОМЕШНАЯ ТЬМА	КОЛИЧЕСТВО, ВЕЛИЧИНА, ЧИСЛО	ВЫШЕ
КРУПИЦА (НЕБОЛЬШОЕ КОЛИЧЕСТВО)	КОЛИЧЕСТВО, ВЕЛИЧИНА, ЧИСЛО	ВЫШЕ
КРЮК ПО ПУТИ	КОЛИЧЕСТВО, ВЕЛИЧИНА, ЧИСЛО	ВЫШЕ
КУБАТУРА (ОБЪЕМ)	КОЛИЧЕСТВО, ВЕЛИЧИНА, ЧИСЛО	ВЫШЕ
КУРСОВАЯ СТОИМОСТЬ	КОЛИЧЕСТВО, ВЕЛИЧИНА, ЧИСЛО	ВЫШЕ
КУЧА, ГРУДА	КОЛИЧЕСТВО, ВЕЛИЧИНА, ЧИСЛО	ВЫШЕ
ЛАВИНА (ДВИЖУЩАЯСЯ МАССА)	КОЛИЧЕСТВО, ВЕЛИЧИНА, ЧИСЛО	ВЫШЕ
ЛЕС (МНОЖЕСТВО ЧЕГО-Н. ПОДНЯТОГО)	КОЛИЧЕСТВО, ВЕЛИЧИНА, ЧИСЛО	ВЫШЕ
ЛИКВИДНОСТЬ (ФИНАНСОВЫЙ ПОКАЗАТЕЛЬ)	КОЛИЧЕСТВО, ВЕЛИЧИНА, ЧИСЛО	ВЫШЕ
ЛИМИТ, ПРЕДЕЛЬНАЯ НОРМА	КОЛИЧЕСТВО, ВЕЛИЧИНА, ЧИСЛО	ВЫШЕ
ЛИТРАЖ	КОЛИЧЕСТВО, ВЕЛИЧИНА, ЧИСЛО	ВЫШЕ
ЛЬГОТНАЯ СТАВКА	КОЛИЧЕСТВО, ВЕЛИЧИНА, ЧИСЛО	ВЫШЕ
МАКСИМУМ	КОЛИЧЕСТВО, ВЕЛИЧИНА, ЧИСЛО	ВЫШЕ
МАССА (НЕРАЗРЫВНОЕ СКОПЛЕНИЕ)	КОЛИЧЕСТВО, ВЕЛИЧИНА, ЧИСЛО	ВЫШЕ
МАССА (ФИЗИЧЕСКАЯ ВЕЛИЧИНА)	КОЛИЧЕСТВО, ВЕЛИЧИНА, ЧИСЛО	ВЫШЕ
МАССА ПРОДУКЦИИ	КОЛИЧЕСТВО, ВЕЛИЧИНА, ЧИСЛО	ВЫШЕ
МАССА ТЕЛА ЧЕЛОВЕКА	КОЛИЧЕСТВО, ВЕЛИЧИНА, ЧИСЛО	ВЫШЕ
МАТЕМАТИЧЕСКАЯ ВЕРОЯТНОСТЬ	КОЛИЧЕСТВО, ВЕЛИЧИНА, ЧИСЛО	ВЫШЕ
МЕЛКОВОДНЫЙ	КОЛИЧЕСТВО, ВЕЛИЧИНА, ЧИСЛО	ВЫШЕ
МЕРКА (ПРОТЯЖЕННОСТЬ)	КОЛИЧЕСТВО, ВЕЛИЧИНА, ЧИСЛО	ВЫШЕ
МЕТРАЖ	КОЛИЧЕСТВО, ВЕЛИЧИНА, ЧИСЛО	ВЫШЕ
МИНИМУМ	КОЛИЧЕСТВО, ВЕЛИЧИНА, ЧИСЛО	ВЫШЕ
МИНУСОВАЯ ТЕМПЕРАТУРА	КОЛИЧЕСТВО, ВЕЛИЧИНА, ЧИСЛО	ВЫШЕ
МНОГОЛЮДЬЕ	КОЛИЧЕСТВО, ВЕЛИЧИНА, ЧИСЛО	ВЫШЕ
МНОЖЕСТВО, БОЛЬШОЕ КОЛИЧЕСТВО	КОЛИЧЕСТВО, ВЕЛИЧИНА, ЧИСЛО	ВЫШЕ
МОБИЛЬНЫЙ НОМЕР	КОЛИЧЕСТВО, ВЕЛИЧИНА, ЧИСЛО	ВЫШЕ
МОМЕНТ (ФИЗИЧЕСКАЯ ВЕЛИЧИНА)	КОЛИЧЕСТВО, ВЕЛИЧИНА, ЧИСЛО	ВЫШЕ
МОНЕТИЗАЦИЯ ЭКОНОМИКИ	КОЛИЧЕСТВО, ВЕЛИЧИНА, ЧИСЛО	ВЫШЕ
МОРЕ (БОЛЬШОЕ КОЛИЧЕСТВО)	КОЛИЧЕСТВО, ВЕЛИЧИНА, ЧИСЛО	ВЫШЕ
МОРЕХОДНЫЕ КАЧЕСТВА	КОЛИЧЕСТВО, ВЕЛИЧИНА, ЧИСЛО	ВЫШЕ
МОЩНОСТЬ (ВЕЛИЧИНА)	КОЛИЧЕСТВО, ВЕЛИЧИНА, ЧИСЛО	ВЫШЕ
МОЩНОСТЬ ВЗРЫВА	КОЛИЧЕСТВО, ВЕЛИЧИНА, ЧИСЛО	ВЫШЕ
МРАК, ТЬМА	КОЛИЧЕСТВО, ВЕЛИЧИНА, ЧИСЛО	ВЫШЕ
НАДОЙ МОЛОКА	КОЛИЧЕСТВО, ВЕЛИЧИНА, ЧИСЛО	ВЫШЕ
НАПЛЫВ (СКОПЛЕНИЕ)	КОЛИЧЕСТВО, ВЕЛИЧИНА, ЧИСЛО	ВЫШЕ
НАПОЛНЯЕМОСТЬ	КОЛИЧЕСТВО, ВЕЛИЧИНА, ЧИСЛО	ВЫШЕ
НАПОР (ДАВЛЕНИЕ)	КОЛИЧЕСТВО, ВЕЛИЧИНА, ЧИСЛО	ВЫШЕ
НАРАБОТКА УСТРОЙСТВА	КОЛИЧЕСТВО, ВЕЛИЧИНА, ЧИСЛО	ВЫШЕ
НЕДОБОР (НЕПОЛНОЕ КОЛИЧЕСТВО)	КОЛИЧЕСТВО, ВЕЛИЧИНА, ЧИСЛО	ВЫШЕ
НЕДОСТАТОК ИНФОРМАЦИИ	КОЛИЧЕСТВО, ВЕЛИЧИНА, ЧИСЛО	ВЫШЕ
НЕДОСТАТОК, НЕДОСТАТОЧНОЕ КОЛИЧЕСТВО	КОЛИЧЕСТВО, ВЕЛИЧИНА, ЧИСЛО	ВЫШЕ
НЕДОСТАЧА	КОЛИЧЕСТВО, ВЕЛИЧИНА, ЧИСЛО	ВЫШЕ
НЕКОМПЛЕКТ	КОЛИЧЕСТВО, ВЕЛИЧИНА, ЧИСЛО	ВЫШЕ
НЕПРИХОТЛИВЫЙ, НЕПРИТЯЗАТЕЛЬНЫЙ	КОЛИЧЕСТВО, ВЕЛИЧИНА, ЧИСЛО	ВЫШЕ
НЕРВНО-МЫШЕЧНЫЙ ТОНУС	КОЛИЧЕСТВО, ВЕЛИЧИНА, ЧИСЛО	ВЫШЕ
НЕРЕНТАБЕЛЬНОСТЬ	КОЛИЧЕСТВО, ВЕЛИЧИНА, ЧИСЛО	ВЫШЕ
НЕТТО	КОЛИЧЕСТВО, ВЕЛИЧИНА, ЧИСЛО	ВЫШЕ
НЕУРОЖАЙ	КОЛИЧЕСТВО, ВЕЛИЧИНА, ЧИСЛО	ВЫШЕ
НЕФТЕОТДАЧА	КОЛИЧЕСТВО, ВЕЛИЧИНА, ЧИСЛО	ВЫШЕ
НЕХВАТКА СВОБОДНОГО ВРЕМЕНИ	КОЛИЧЕСТВО, ВЕЛИЧИНА, ЧИСЛО	ВЫШЕ
НИЗКОЕ НАПРЯЖЕНИЕ	КОЛИЧЕСТВО, ВЕЛИЧИНА, ЧИСЛО	ВЫШЕ
НИЩЕТА, КРАЙНЯЯ БЕДНОСТЬ	КОЛИЧЕСТВО, ВЕЛИЧИНА, ЧИСЛО	ВЫШЕ
НОМЕР ПО ПОРЯДКУ	КОЛИЧЕСТВО, ВЕЛИЧИНА, ЧИСЛО	ВЫШЕ
НОМЕР ФАКСА	КОЛИЧЕСТВО, ВЕЛИЧИНА, ЧИСЛО	ВЫШЕ
НОМИНАЛЬНАЯ СТОИМОСТЬ	КОЛИЧЕСТВО, ВЕЛИЧИНА, ЧИСЛО	ВЫШЕ
НОРМА (ВЕЛИЧИНА)	КОЛИЧЕСТВО, ВЕЛИЧИНА, ЧИСЛО	ВЫШЕ
НОРМАТИВ	КОЛИЧЕСТВО, ВЕЛИЧИНА, ЧИСЛО	ВЫШЕ
ОБИЛИЕ, ИЗОБИЛИЕ	КОЛИЧЕСТВО, ВЕЛИЧИНА, ЧИСЛО	ВЫШЕ
ОБТЕКАЕМОСТЬ ТРАНСПОРТНОГО СРЕДСТВА	КОЛИЧЕСТВО, ВЕЛИЧИНА, ЧИСЛО	ВЫШЕ
ОБХВАТ (РАЗМЕР)	КОЛИЧЕСТВО, ВЕЛИЧИНА, ЧИСЛО	ВЫШЕ
ОБЪЕМ (ВЕЛИЧИНА В ДЛИНУ, ШИРИНУ И ВЫСОТУ)	КОЛИЧЕСТВО, ВЕЛИЧИНА, ЧИСЛО	ВЫШЕ
ОДНОКРАТНЫЙ	КОЛИЧЕСТВО, ВЕЛИЧИНА, ЧИСЛО	ВЫШЕ
ОДНОРАЗОВЫЙ	КОЛИЧЕСТВО, ВЕЛИЧИНА, ЧИСЛО	ВЫШЕ
ОКЛАД	КОЛИЧЕСТВО, ВЕЛИЧИНА, ЧИСЛО	ВЫШЕ
ОКТАНОВОЕ ЧИСЛО	КОЛИЧЕСТВО, ВЕЛИЧИНА, ЧИСЛО	ВЫШЕ
ОКУПАЕМОСТЬ КАПИТАЛЬНЫХ ВЛОЖЕНИЙ	КОЛИЧЕСТВО, ВЕЛИЧИНА, ЧИСЛО	ВЫШЕ
ОПТОВАЯ ЦЕНА	КОЛИЧЕСТВО, ВЕЛИЧИНА, ЧИСЛО	ВЫШЕ
ОСАДКА СУДНА	КОЛИЧЕСТВО, ВЕЛИЧИНА, ЧИСЛО	ВЫШЕ
ОСВЕЩЕННОСТЬ (СТЕПЕНЬ ОСВЕЩЕНИЯ)	КОЛИЧЕСТВО, ВЕЛИЧИНА, ЧИСЛО	ВЫШЕ
ОСНОВНОЙ ЭКОНОМИЧЕСКИЙ ПОКАЗАТЕЛЬ	КОЛИЧЕСТВО, ВЕЛИЧИНА, ЧИСЛО	ВЫШЕ
ОСТАТОК ОТ ДЕЛЕНИЯ	КОЛИЧЕСТВО, ВЕЛИЧИНА, ЧИСЛО	ВЫШЕ
ОСТРЫЙ НЕДОСТАТОК	КОЛИЧЕСТВО, ВЕЛИЧИНА, ЧИСЛО	ВЫШЕ
ОТЛОЖЕНИЕ ВЕЩЕСТВ	КОЛИЧЕСТВО, ВЕЛИЧИНА, ЧИСЛО	ВЫШЕ
ОТСТАВАНИЕ ЧАСОВ	КОЛИЧЕСТВО, ВЕЛИЧИНА, ЧИСЛО	ВЫШЕ
ПАРАМЕТР	КОЛИЧЕСТВО, ВЕЛИЧИНА, ЧИСЛО	ВЫШЕ
ПАРАМЕТР ФУНКЦИИ	КОЛИЧЕСТВО, ВЕЛИЧИНА, ЧИСЛО	ВЫШЕ
ПАССАЖИРООБОРОТ	КОЛИЧЕСТВО, ВЕЛИЧИНА, ЧИСЛО	ВЫШЕ
ПЕРЕМЕННАЯ ВЕЛИЧИНА	КОЛИЧЕСТВО, ВЕЛИЧИНА, ЧИСЛО	ВЫШЕ
ПЕРИМЕТР ГЕОМЕТРИЧЕСКОЙ ФИГУРЫ	КОЛИЧЕСТВО, ВЕЛИЧИНА, ЧИСЛО	ВЫШЕ
ПИН-КОД	КОЛИЧЕСТВО, ВЕЛИЧИНА, ЧИСЛО	ВЫШЕ
ПИЩЕВАЯ ЦЕННОСТЬ	КОЛИЧЕСТВО, ВЕЛИЧИНА, ЧИСЛО	ВЫШЕ
ПЛАТЕЖЕСПОСОБНОСТЬ	КОЛИЧЕСТВО, ВЕЛИЧИНА, ЧИСЛО	ВЫШЕ
ПЛЕЧО РЫЧАГА	КОЛИЧЕСТВО, ВЕЛИЧИНА, ЧИСЛО	ВЫШЕ
ПЛОТНОСТЬ ВЕЩЕСТВА	КОЛИЧЕСТВО, ВЕЛИЧИНА, ЧИСЛО	ВЫШЕ
ПЛОЩАДЬ (ПАРАМЕТР)	КОЛИЧЕСТВО, ВЕЛИЧИНА, ЧИСЛО	ВЫШЕ
ПЛОЩАДЬ ЖИЛЬЯ	КОЛИЧЕСТВО, ВЕЛИЧИНА, ЧИСЛО	ВЫШЕ
ПЛОЩАДЬ ПОМЕЩЕНИЯ	КОЛИЧЕСТВО, ВЕЛИЧИНА, ЧИСЛО	ВЫШЕ
ПЛЮСОВАЯ ТЕМПЕРАТУРА	КОЛИЧЕСТВО, ВЕЛИЧИНА, ЧИСЛО	ВЫШЕ
ПОГОЛОВЬЕ СКОТА	КОЛИЧЕСТВО, ВЕЛИЧИНА, ЧИСЛО	ВЫШЕ
ПОКАЗАНИЯ ПРИБОРА	КОЛИЧЕСТВО, ВЕЛИЧИНА, ЧИСЛО	ВЫШЕ
ПОКАЗАТЕЛЬ (ДАННЫЕ)	КОЛИЧЕСТВО, ВЕЛИЧИНА, ЧИСЛО	ВЫШЕ
ПОКАЗАТЕЛЬ ДЕЯТЕЛЬНОСТИ БАНКА	КОЛИЧЕСТВО, ВЕЛИЧИНА, ЧИСЛО	ВЫШЕ
ПОКАЗАТЕЛЬ ДОХОДНОСТИ	КОЛИЧЕСТВО, ВЕЛИЧИНА, ЧИСЛО	ВЫШЕ
ПОКАЗАТЕЛЬ СТЕПЕНИ	КОЛИЧЕСТВО, ВЕЛИЧИНА, ЧИСЛО	ВЫШЕ
ПОКУПНАЯ ЦЕНА	КОЛИЧЕСТВО, ВЕЛИЧИНА, ЧИСЛО	ВЫШЕ
ПОЛМЕТРА	КОЛИЧЕСТВО, ВЕЛИЧИНА, ЧИСЛО	ВЫШЕ
ПОЛНОВОДНЫЙ, ГЛУБОКОВОДНЫЙ	КОЛИЧЕСТВО, ВЕЛИЧИНА, ЧИСЛО	ВЫШЕ
ПОЛОВИНА ПУТИ	КОЛИЧЕСТВО, ВЕЛИЧИНА, ЧИСЛО	ВЫШЕ
ПОЛУСРЕДНИЙ ВЕС	КОЛИЧЕСТВО, ВЕЛИЧИНА, ЧИСЛО	ВЫШЕ
ПОЛУТЯЖЕЛЫЙ ВЕС	КОЛИЧЕСТВО, ВЕЛИЧИНА, ЧИСЛО	ВЫШЕ
ПОЛЧИЩЕ (НЕСМЕТНОЕ КОЛИЧЕСТВО)	КОЛИЧЕСТВО, ВЕЛИЧИНА, ЧИСЛО	ВЫШЕ
ПОПЕРЕЧНИК	КОЛИЧЕСТВО, ВЕЛИЧИНА, ЧИСЛО	ВЫШЕ
ПОРОГ, ПОРОГОВОЕ ЗНАЧЕНИЕ	КОЛИЧЕСТВО, ВЕЛИЧИНА, ЧИСЛО	ВЫШЕ
ПОСЕЩАЕМОСТЬ	КОЛИЧЕСТВО, ВЕЛИЧИНА, ЧИСЛО	ВЫШЕ
ПОСЛУШНЫЙ В УПРАВЛЕНИИ	КОЛИЧЕСТВО, ВЕЛИЧИНА, ЧИСЛО	ВЫШЕ
ПОТЕНЦИАЛ (ФИЗИЧЕСКАЯ ВЕЛИЧИНА)	КОЛИЧЕСТВО, ВЕЛИЧИНА, ЧИСЛО	ВЫШЕ
ПОТРЕБИТЕЛЬСКАЯ (РОЗНИЧНАЯ) ЦЕНА	КОЛИЧЕСТВО, ВЕЛИЧИНА, ЧИСЛО	ВЫШЕ
ПРЕДЕЛЬНЫЙ ДОПУСК	КОЛИЧЕСТВО, ВЕЛИЧИНА, ЧИСЛО	ВЫШЕ
ПРЕМИУМ КЛАСС	КОЛИЧЕСТВО, ВЕЛИЧИНА, ЧИСЛО	ВЫШЕ
ПРИГОРШНЯ (КОЛИЧЕСТВО)	КОЛИЧЕСТВО, ВЕЛИЧИНА, ЧИСЛО	ВЫШЕ
ПРОБЕГ ТРАНСПОРТНОГО СРЕДСТВА	КОЛИЧЕСТВО, ВЕЛИЧИНА, ЧИСЛО	ВЫШЕ
ПРОИЗВЕДЕНИЕ, РЕЗУЛЬТАТ УМНОЖЕНИЯ	КОЛИЧЕСТВО, ВЕЛИЧИНА, ЧИСЛО	ВЫШЕ
ПРОИЗВОДИТЕЛЬНОСТЬ (ПОКАЗАТЕЛЬ)	КОЛИЧЕСТВО, ВЕЛИЧИНА, ЧИСЛО	ВЫШЕ
ПРОИЗВОДИТЕЛЬНОСТЬ ТРУДА	КОЛИЧЕСТВО, ВЕЛИЧИНА, ЧИСЛО	ВЫШЕ
ПРОИЗВОДСТВЕННАЯ МОЩНОСТЬ	КОЛИЧЕСТВО, ВЕЛИЧИНА, ЧИСЛО	ВЫШЕ
ПРОПОРЦИЯ (КОЛИЧЕСТВЕННОЕ СООТНОШЕНИЕ)	КОЛИЧЕСТВО, ВЕЛИЧИНА, ЧИСЛО	ВЫШЕ
ПРОСВЕТ ПРОЕМА	КОЛИЧЕСТВО, ВЕЛИЧИНА, ЧИСЛО	ВЫШЕ
ПРОСТОЕ БОЛЬШИНСТВО ГОЛОСОВ	КОЛИЧЕСТВО, ВЕЛИЧИНА, ЧИСЛО	ВЫШЕ
ПРОТЯЖЕННОСТЬ	КОЛИЧЕСТВО, ВЕЛИЧИНА, ЧИСЛО	ВЫШЕ
ПРОХОДНОЙ БАЛЛ	КОЛИЧЕСТВО, ВЕЛИЧИНА, ЧИСЛО	ВЫШЕ
ПРОЦЕНТНАЯ СТАВКА	КОЛИЧЕСТВО, ВЕЛИЧИНА, ЧИСЛО	ВЫШЕ
ПРОЦЕНТНАЯ СТАВКА КРЕДИТА	КОЛИЧЕСТВО, ВЕЛИЧИНА, ЧИСЛО	ВЫШЕ
ПРОЦЕНТНОЕ ОТНОШЕНИЕ	КОЛИЧЕСТВО, ВЕЛИЧИНА, ЧИСЛО	ВЫШЕ
РАДИОЧАСТОТА	КОЛИЧЕСТВО, ВЕЛИЧИНА, ЧИСЛО	ВЫШЕ
РАДИУС ДЕЙСТВИЯ	КОЛИЧЕСТВО, ВЕЛИЧИНА, ЧИСЛО	ВЫШЕ
РАДИУС КРУГА, ШАРА	КОЛИЧЕСТВО, ВЕЛИЧИНА, ЧИСЛО	ВЫШЕ
РАЗМАХ МЕЖДУ КРАЙНИМИ ТОЧКАМИ	КОЛИЧЕСТВО, ВЕЛИЧИНА, ЧИСЛО	ВЫШЕ
РАЗМЕРНОСТЬ, ЧИСЛО ИЗМЕРЕНИЙ	КОЛИЧЕСТВО, ВЕЛИЧИНА, ЧИСЛО	ВЫШЕ
РАЗРЕШЕНИЕ ИЗОБРАЖЕНИЯ	КОЛИЧЕСТВО, ВЕЛИЧИНА, ЧИСЛО	ВЫШЕ
РАСКРЫВАЕМОСТЬ ПРЕСТУПЛЕНИЙ	КОЛИЧЕСТВО, ВЕЛИЧИНА, ЧИСЛО	ВЫШЕ
РАССТОЯНИЕ	КОЛИЧЕСТВО, ВЕЛИЧИНА, ЧИСЛО	ВЫШЕ
РАСЦЕНКИ НА УСЛУГИ	КОЛИЧЕСТВО, ВЕЛИЧИНА, ЧИСЛО	ВЫШЕ
РЕЙТИНГ	КОЛИЧЕСТВО, ВЕЛИЧИНА, ЧИСЛО	ВЫШЕ
РЕЙТИНГ ПОПУЛЯРНОСТИ	КОЛИЧЕСТВО, ВЕЛИЧИНА, ЧИСЛО	ВЫШЕ
РЕКОРД	КОЛИЧЕСТВО, ВЕЛИЧИНА, ЧИСЛО	ВЫШЕ
РЕНТАБЕЛЬНОСТЬ	КОЛИЧЕСТВО, ВЕЛИЧИНА, ЧИСЛО	ВЫШЕ
РОСТ ЧЕЛОВЕКА, ЖИВОТНОГО	КОЛИЧЕСТВО, ВЕЛИЧИНА, ЧИСЛО	ВЫШЕ
РЫНОЧНАЯ КАПИТАЛИЗАЦИЯ	КОЛИЧЕСТВО, ВЕЛИЧИНА, ЧИСЛО	ВЫШЕ
РЫНОЧНАЯ ЦЕНА	КОЛИЧЕСТВО, ВЕЛИЧИНА, ЧИСЛО	ВЫШЕ
СВЕРХЗВУКОВАЯ СКОРОСТЬ	КОЛИЧЕСТВО, ВЕЛИЧИНА, ЧИСЛО	ВЫШЕ
СДЕЛЬНЫЕ РАСЦЕНКИ	КОЛИЧЕСТВО, ВЕЛИЧИНА, ЧИСЛО	ВЫШЕ
СЕБЕСТОИМОСТЬ	КОЛИЧЕСТВО, ВЕЛИЧИНА, ЧИСЛО	ВЫШЕ
СЕЙСМИЧНОСТЬ	КОЛИЧЕСТВО, ВЕЛИЧИНА, ЧИСЛО	ВЫШЕ
СЕЛЬСКОХОЗЯЙСТВЕННЫЙ ПОКАЗАТЕЛЬ	КОЛИЧЕСТВО, ВЕЛИЧИНА, ЧИСЛО	ВЫШЕ
СИЛА (ФИЗИЧЕСКАЯ ВЕЛИЧИНА)	КОЛИЧЕСТВО, ВЕЛИЧИНА, ЧИСЛО	ВЫШЕ
СИЛА ВЕСА	КОЛИЧЕСТВО, ВЕЛИЧИНА, ЧИСЛО	ВЫШЕ
СИЛА ПРИТЯЖЕНИЯ	КОЛИЧЕСТВО, ВЕЛИЧИНА, ЧИСЛО	ВЫШЕ
СИЛА ТОКА	КОЛИЧЕСТВО, ВЕЛИЧИНА, ЧИСЛО	ВЫШЕ
СИЛА ТЯГИ	КОЛИЧЕСТВО, ВЕЛИЧИНА, ЧИСЛО	ВЫШЕ
СКИРД, КОПНА	КОЛИЧЕСТВО, ВЕЛИЧИНА, ЧИСЛО	ВЫШЕ
СКЛАД (БОЛЬШОЕ КОЛИЧЕСТВО)	КОЛИЧЕСТВО, ВЕЛИЧИНА, ЧИСЛО	ВЫШЕ
СКОПЛЕНИЕ (БОЛЬШОЕ КОЛИЧЕСТВО)	КОЛИЧЕСТВО, ВЕЛИЧИНА, ЧИСЛО	ВЫШЕ
СКОПЛЕНИЕ ЗВЕЗД	КОЛИЧЕСТВО, ВЕЛИЧИНА, ЧИСЛО	ВЫШЕ
СКОРОСТРЕЛЬНОСТЬ	КОЛИЧЕСТВО, ВЕЛИЧИНА, ЧИСЛО	ВЫШЕ
СКОРОСТЬ ВРАЩЕНИЯ	КОЛИЧЕСТВО, ВЕЛИЧИНА, ЧИСЛО	ВЫШЕ
СКОРОСТЬ ДВИЖЕНИЯ	КОЛИЧЕСТВО, ВЕЛИЧИНА, ЧИСЛО	ВЫШЕ
СЛИШКОМ ДЕШЕВЫЙ	КОЛИЧЕСТВО, ВЕЛИЧИНА, ЧИСЛО	ВЫШЕ
СНЕЖНЫЕ ЗАНОСЫ	КОЛИЧЕСТВО, ВЕЛИЧИНА, ЧИСЛО	ВЫШЕ
СНИЖЕННАЯ ЦЕНА	КОЛИЧЕСТВО, ВЕЛИЧИНА, ЧИСЛО	ВЫШЕ
СОБИРАЕМОСТЬ ПЛАТЕЖЕЙ	КОЛИЧЕСТВО, ВЕЛИЧИНА, ЧИСЛО	ВЫШЕ
СОНМ (БОЛЬШОЕ КОЛИЧЕСТВО)	КОЛИЧЕСТВО, ВЕЛИЧИНА, ЧИСЛО	ВЫШЕ
СОЦИАЛЬНО-ЭКОНОМИЧЕСКИЙ ПОКАЗАТЕЛЬ	КОЛИЧЕСТВО, ВЕЛИЧИНА, ЧИСЛО	ВЫШЕ
СОЦИАЛЬНЫЙ ПОКАЗАТЕЛЬ	КОЛИЧЕСТВО, ВЕЛИЧИНА, ЧИСЛО	ВЫШЕ
СПОРТИВНАЯ ДИСТАНЦИЯ	КОЛИЧЕСТВО, ВЕЛИЧИНА, ЧИСЛО	ВЫШЕ
СПОРТИВНЫЙ РЕКОРД	КОЛИЧЕСТВО, ВЕЛИЧИНА, ЧИСЛО	ВЫШЕ
СРЕДНЕВЗВЕШЕННАЯ ВЕЛИЧИНА	КОЛИЧЕСТВО, ВЕЛИЧИНА, ЧИСЛО	ВЫШЕ
СРЕДНЕГОДОВОЕ ЗНАЧЕНИЕ	КОЛИЧЕСТВО, ВЕЛИЧИНА, ЧИСЛО	ВЫШЕ
СРЕДНЕЕ АРИФМЕТИЧЕСКОЕ	КОЛИЧЕСТВО, ВЕЛИЧИНА, ЧИСЛО	ВЫШЕ
СРЕДНЕМЕСЯЧНОЕ ЗНАЧЕНИЕ	КОЛИЧЕСТВО, ВЕЛИЧИНА, ЧИСЛО	ВЫШЕ
СРЕДНЕСТАТИСТИЧЕСКИЙ	КОЛИЧЕСТВО, ВЕЛИЧИНА, ЧИСЛО	ВЫШЕ
СРЕДНИЙ ПО СВОЙСТВАМ, ПРИЗНАКАМ	КОЛИЧЕСТВО, ВЕЛИЧИНА, ЧИСЛО	ВЫШЕ
СРЕДНЯЯ ВЕЛИЧИНА	КОЛИЧЕСТВО, ВЕЛИЧИНА, ЧИСЛО	ВЫШЕ
СТАВКА ОПЛАТЫ	КОЛИЧЕСТВО, ВЕЛИЧИНА, ЧИСЛО	ВЫШЕ
СТАТИСТИЧЕСКИЕ ДАННЫЕ	КОЛИЧЕСТВО, ВЕЛИЧИНА, ЧИСЛО	ВЫШЕ
СТАТИСТИЧЕСКИЙ ПОКАЗАТЕЛЬ	КОЛИЧЕСТВО, ВЕЛИЧИНА, ЧИСЛО	ВЫШЕ
СТОГ	КОЛИЧЕСТВО, ВЕЛИЧИНА, ЧИСЛО	ВЫШЕ
СТОИМОСТЬ	КОЛИЧЕСТВО, ВЕЛИЧИНА, ЧИСЛО	ВЫШЕ
СТОИМОСТЬ КРЕДИТА	КОЛИЧЕСТВО, ВЕЛИЧИНА, ЧИСЛО	ВЫШЕ
СТОЛБ (ПОДНИМАЮЩАЯСЯ МАССА)	КОЛИЧЕСТВО, ВЕЛИЧИНА, ЧИСЛО	ВЫШЕ
СТОМЕТРОВКА	КОЛИЧЕСТВО, ВЕЛИЧИНА, ЧИСЛО	ВЫШЕ
СТОПКА ПРЕДМЕТОВ	КОЛИЧЕСТВО, ВЕЛИЧИНА, ЧИСЛО	ВЫШЕ
СУГРОБ СНЕГА	КОЛИЧЕСТВО, ВЕЛИЧИНА, ЧИСЛО	ВЫШЕ
СУММА, РЕЗУЛЬТАТ СЛОЖЕНИЯ	КОЛИЧЕСТВО, ВЕЛИЧИНА, ЧИСЛО	ВЫШЕ
СУПЕРТЯЖЕЛЫЙ ВЕС	КОЛИЧЕСТВО, ВЕЛИЧИНА, ЧИСЛО	ВЫШЕ
СУТОЛОКА, ТОЛКОТНЯ	КОЛИЧЕСТВО, ВЕЛИЧИНА, ЧИСЛО	ВЫШЕ
ТАКТИКО-ТЕХНИЧЕСКИЕ ХАРАКТЕРИСТИКИ	КОЛИЧЕСТВО, ВЕЛИЧИНА, ЧИСЛО	ВЫШЕ
ТАКТОВАЯ ЧАСТОТА	КОЛИЧЕСТВО, ВЕЛИЧИНА, ЧИСЛО	ВЫШЕ
ТАРИФ	КОЛИЧЕСТВО, ВЕЛИЧИНА, ЧИСЛО	ВЫШЕ
ТАРИФЫ НА УСЛУГИ	КОЛИЧЕСТВО, ВЕЛИЧИНА, ЧИСЛО	ВЫШЕ
ТЕКУЧЕСТЬ КАДРОВ	КОЛИЧЕСТВО, ВЕЛИЧИНА, ЧИСЛО	ВЫШЕ
ТЕЛЕФОННЫЙ НОМЕР	КОЛИЧЕСТВО, ВЕЛИЧИНА, ЧИСЛО	ВЫШЕ
ТЕМПЕРАТУРА	КОЛИЧЕСТВО, ВЕЛИЧИНА, ЧИСЛО	ВЫШЕ
ТЕМПЕРАТУРА ВОЗДУХА	КОЛИЧЕСТВО, ВЕЛИЧИНА, ЧИСЛО	ВЫШЕ
ТЕМПЕРАТУРА ТЕЛА	КОЛИЧЕСТВО, ВЕЛИЧИНА, ЧИСЛО	ВЫШЕ
ТЕПЛОЕМКОСТЬ	КОЛИЧЕСТВО, ВЕЛИЧИНА, ЧИСЛО	ВЫШЕ
ТЕРМОДИНАМИЧЕСКАЯ ЭНТРОПИЯ	КОЛИЧЕСТВО, ВЕЛИЧИНА, ЧИСЛО	ВЫШЕ
ТЕХНИКО-ЭКОНОМИЧЕСКИЙ ПОКАЗАТЕЛЬ	КОЛИЧЕСТВО, ВЕЛИЧИНА, ЧИСЛО	ВЫШЕ
ТЕХНИКО-ЭКСПЛУАТАЦИОННЫЙ ПОКАЗАТЕЛЬ	КОЛИЧЕСТВО, ВЕЛИЧИНА, ЧИСЛО	ВЫШЕ
ТЕХНИЧЕСКИЕ НОРМЫ	КОЛИЧЕСТВО, ВЕЛИЧИНА, ЧИСЛО	ВЫШЕ
ТЕХНИЧЕСКИЕ УСЛОВИЯ (НОРМАТИВ)	КОЛИЧЕСТВО, ВЕЛИЧИНА, ЧИСЛО	ВЫШЕ
ТЕХНИЧЕСКИЙ ПОКАЗАТЕЛЬ	КОЛИЧЕСТВО, ВЕЛИЧИНА, ЧИСЛО	ВЫШЕ
ТИРАЖ ПЕЧАТНОГО ИЗДАНИЯ	КОЛИЧЕСТВО, ВЕЛИЧИНА, ЧИСЛО	ВЫШЕ
ТОВАРООБОРОТ	КОЛИЧЕСТВО, ВЕЛИЧИНА, ЧИСЛО	ВЫШЕ
ТОЛПА ЛЮДЕЙ	КОЛИЧЕСТВО, ВЕЛИЧИНА, ЧИСЛО	ВЫШЕ
ТОЛЩИНА (ПРОТЯЖЕННОСТЬ)	КОЛИЧЕСТВО, ВЕЛИЧИНА, ЧИСЛО	ВЫШЕ
ТРАНСПОРТНЫЙ ТАРИФ	КОЛИЧЕСТВО, ВЕЛИЧИНА, ЧИСЛО	ВЫШЕ
ТРАФИК СЕТИ	КОЛИЧЕСТВО, ВЕЛИЧИНА, ЧИСЛО	ВЫШЕ
ТРЕХМЕРНЫЙ	КОЛИЧЕСТВО, ВЕЛИЧИНА, ЧИСЛО	ВЫШЕ
ТУМАННОСТЬ (КОСМИЧЕСКИЙ ОБЪЕКТ)	КОЛИЧЕСТВО, ВЕЛИЧИНА, ЧИСЛО	ВЫШЕ
ТУСКЛЫЙ, НЕЯРКИЙ	КОЛИЧЕСТВО, ВЕЛИЧИНА, ЧИСЛО	ВЫШЕ
ТУЧА (МНОЖЕСТВО)	КОЛИЧЕСТВО, ВЕЛИЧИНА, ЧИСЛО	ВЫШЕ
УБЕГАНИЕ ЧАСОВ	КОЛИЧЕСТВО, ВЕЛИЧИНА, ЧИСЛО	ВЫШЕ
УБЫТОК	КОЛИЧЕСТВО, ВЕЛИЧИНА, ЧИСЛО	ВЫШЕ
УДЕЛЬНЫЙ ПАРАМЕТР	КОЛИЧЕСТВО, ВЕЛИЧИНА, ЧИСЛО	ВЫШЕ
УЛОВ	КОЛИЧЕСТВО, ВЕЛИЧИНА, ЧИСЛО	ВЫШЕ
УМЕРЕННЫЙ (СРЕДНИЙ)	КОЛИЧЕСТВО, ВЕЛИЧИНА, ЧИСЛО	ВЫШЕ
УСКОРЕНИЕ (ФИЗИЧЕСКАЯ ВЕЛИЧИНА)	КОЛИЧЕСТВО, ВЕЛИЧИНА, ЧИСЛО	ВЫШЕ
УСРЕДНЕННЫЙ	КОЛИЧЕСТВО, ВЕЛИЧИНА, ЧИСЛО	ВЫШЕ
ФИЗИЧЕСКАЯ ВЕЛИЧИНА	КОЛИЧЕСТВО, ВЕЛИЧИНА, ЧИСЛО	ВЫШЕ
ФИНАНСОВЫЕ РЕЗУЛЬТАТЫ	КОЛИЧЕСТВО, ВЕЛИЧИНА, ЧИСЛО	ВЫШЕ
ФИНАНСОВЫЙ ПОКАЗАТЕЛЬ	КОЛИЧЕСТВО, ВЕЛИЧИНА, ЧИСЛО	ВЫШЕ
ФИНИШНАЯ ЧАСТЬ ДИСТАНЦИИ	КОЛИЧЕСТВО, ВЕЛИЧИНА, ЧИСЛО	ВЫШЕ
ФОНТАН ЧАСТИЦ	КОЛИЧЕСТВО, ВЕЛИЧИНА, ЧИСЛО	ВЫШЕ
ФОРМАТ БУМАГИ	КОЛИЧЕСТВО, ВЕЛИЧИНА, ЧИСЛО	ВЫШЕ
ХАРАКТЕРИСТИКА ТРАНСПОРТНОГО СРЕДСТВА	КОЛИЧЕСТВО, ВЕЛИЧИНА, ЧИСЛО	ВЫШЕ
ХОДОВЫЕ КАЧЕСТВА	КОЛИЧЕСТВО, ВЕЛИЧИНА, ЧИСЛО	ВЫШЕ
ХОЛОД (НИЗКАЯ ТЕМПЕРАТУРА ВОЗДУХА)	КОЛИЧЕСТВО, ВЕЛИЧИНА, ЧИСЛО	ВЫШЕ
ХОЛОДНАЯ ПОГОДА	КОЛИЧЕСТВО, ВЕЛИЧИНА, ЧИСЛО	ВЫШЕ
ЦЕЙТНОТ, НЕДОСТАТОК ВРЕМЕНИ	КОЛИЧЕСТВО, ВЕЛИЧИНА, ЧИСЛО	ВЫШЕ
ЦЕНА ТОВАРА, УСЛУГИ	КОЛИЧЕСТВО, ВЕЛИЧИНА, ЧИСЛО	ВЫШЕ
ЦЕНТРОБЕЖНАЯ СИЛА	КОЛИЧЕСТВО, ВЕЛИЧИНА, ЧИСЛО	ВЫШЕ
ЦИНГА	КОЛИЧЕСТВО, ВЕЛИЧИНА, ЧИСЛО	ВЫШЕ
ЧАСТОТА В ЕДИНИЦУ ВРЕМЕНИ	КОЛИЧЕСТВО, ВЕЛИЧИНА, ЧИСЛО	ВЫШЕ
ЧАСТОТНОСТЬ (ЧАСТОТА ПОЯВЛЕНИЯ)	КОЛИЧЕСТВО, ВЕЛИЧИНА, ЧИСЛО	ВЫШЕ
ЧИСЛЕННОСТЬ	КОЛИЧЕСТВО, ВЕЛИЧИНА, ЧИСЛО	ВЫШЕ
ШИРИНА	КОЛИЧЕСТВО, ВЕЛИЧИНА, ЧИСЛО	ВЫШЕ
ШТАТНАЯ ЧИСЛЕННОСТЬ	КОЛИЧЕСТВО, ВЕЛИЧИНА, ЧИСЛО	ВЫШЕ
ЭКОНОМИЧЕСКИЙ ПОКАЗАТЕЛЬ	КОЛИЧЕСТВО, ВЕЛИЧИНА, ЧИСЛО	ВЫШЕ
ЭКОНОМИЧНОСТЬ	КОЛИЧЕСТВО, ВЕЛИЧИНА, ЧИСЛО	ВЫШЕ
ЭЛАСТИЧНОСТЬ СПРОСА И ПРЕДЛОЖЕНИЯ	КОЛИЧЕСТВО, ВЕЛИЧИНА, ЧИСЛО	ВЫШЕ
ЭЛЕКТРИЧЕСКАЯ ЕМКОСТЬ	КОЛИЧЕСТВО, ВЕЛИЧИНА, ЧИСЛО	ВЫШЕ
ЭЛЕКТРИЧЕСКОЕ НАПРЯЖЕНИЕ	КОЛИЧЕСТВО, ВЕЛИЧИНА, ЧИСЛО	ВЫШЕ
ЭНЕРГЕТИЧЕСКИЙ ТАРИФ	КОЛИЧЕСТВО, ВЕЛИЧИНА, ЧИСЛО	ВЫШЕ
ЭНЕРГОЕМКОСТЬ	КОЛИЧЕСТВО, ВЕЛИЧИНА, ЧИСЛО	ВЫШЕ
ЭПИДЕМИЧЕСКИЙ ПОРОГ	КОЛИЧЕСТВО, ВЕЛИЧИНА, ЧИСЛО	ВЫШЕ
ЭТАП ДИСТАНЦИИ	КОЛИЧЕСТВО, ВЕЛИЧИНА, ЧИСЛО	ВЫШЕ
ЭШЕЛОН ПОЛЕТА	КОЛИЧЕСТВО, ВЕЛИЧИНА, ЧИСЛО	ВЫШЕ
ЯРКИЙ ПО СВЕТУ	КОЛИЧЕСТВО, ВЕЛИЧИНА, ЧИСЛО	ВЫШЕ
ЯРКОСТЬ СВЕТА	КОЛИЧЕСТВО, ВЕЛИЧИНА, ЧИСЛО	ВЫШЕ
АБРИКОСОВЫЙ ЦВЕТ	ФИЗИЧЕСКОЕ СВОЙСТВО	ВЫШЕ
АВОКАДО (ЦВЕТ)	ФИЗИЧЕСКОЕ СВОЙСТВО	ВЫШЕ
АЖУРНЫЙ (СКВОЗНОЙ, СЕТЧАТЫЙ)	ФИЗИЧЕСКОЕ СВОЙСТВО	ВЫШЕ
АКУСТИЧЕСКИЕ СВОЙСТВА	ФИЗИЧЕСКОЕ СВОЙСТВО	ВЫШЕ
АЛЫЙ ЦВЕТ	ФИЗИЧЕСКОЕ СВОЙСТВО	ВЫШЕ
АМОРФНОЕ СТРОЕНИЕ	ФИЗИЧЕСКОЕ СВОЙСТВО	ВЫШЕ
АПЕЛЬСИНОВЫЙ ЦВЕТ	ФИЗИЧЕСКОЕ СВОЙСТВО	ВЫШЕ
АТОМНАЯ ЭНЕРГИЯ	ФИЗИЧЕСКОЕ СВОЙСТВО	ВЫШЕ
БАГРОВЫЙ ЦВЕТ	ФИЗИЧЕСКОЕ СВОЙСТВО	ВЫШЕ
БЕЖЕВЫЙ ЦВЕТ	ФИЗИЧЕСКОЕ СВОЙСТВО	ВЫШЕ
БЕЗРАЗМЕРНЫЙ (ПРИОБРЕТАЮЩИЙ НУЖНЫЙ РАЗМЕР ПРИ НАТЯГИВАНИИ)	ФИЗИЧЕСКОЕ СВОЙСТВО	ВЫШЕ
БЕЛЕСЫЙ (ТУСКЛЫЙ И СВЕТЛЫЙ ДО БЕЛИЗНЫ)	ФИЗИЧЕСКОЕ СВОЙСТВО	ВЫШЕ
БЕЛОКУРЫЙ	ФИЗИЧЕСКОЕ СВОЙСТВО	ВЫШЕ
БЕЛОСНЕЖНЫЙ	ФИЗИЧЕСКОЕ СВОЙСТВО	ВЫШЕ
БЕЛЫЙ (СВЕТЛЫЙ)	ФИЗИЧЕСКОЕ СВОЙСТВО	ВЫШЕ
БЕЛЫЙ ЦВЕТ	ФИЗИЧЕСКОЕ СВОЙСТВО	ВЫШЕ
БЕСКРОВНЫЙ, БЕСКРОВНО БЛЕДНЫЙ	ФИЗИЧЕСКОЕ СВОЙСТВО	ВЫШЕ
БЕСФОРМЕННЫЙ	ФИЗИЧЕСКОЕ СВОЙСТВО	ВЫШЕ
БЕСЦВЕТНЫЙ	ФИЗИЧЕСКОЕ СВОЙСТВО	ВЫШЕ
БЕСШУМНЫЙ	ФИЗИЧЕСКОЕ СВОЙСТВО	ВЫШЕ
БИРЮЗОВЫЙ ЦВЕТ	ФИЗИЧЕСКОЕ СВОЙСТВО	ВЫШЕ
БЛЕДНОСТЬ ЛИЦА	ФИЗИЧЕСКОЕ СВОЙСТВО	ВЫШЕ
БЛЕДНЫЙ ПО ОКРАСКЕ	ФИЗИЧЕСКОЕ СВОЙСТВО	ВЫШЕ
БЛЕКЛЫЙ (БЕСЦВЕТНЫЙ)	ФИЗИЧЕСКОЕ СВОЙСТВО	ВЫШЕ
БЛЕСК (ЯРКИЙ, ИСКРЯЩИЙСЯ СВЕТ)	ФИЗИЧЕСКОЕ СВОЙСТВО	ВЫШЕ
БЛИК СВЕТА	ФИЗИЧЕСКОЕ СВОЙСТВО	ВЫШЕ
БОЛОТИСТЫЙ	ФИЗИЧЕСКОЕ СВОЙСТВО	ВЫШЕ
БОЛОТНЫЙ ЦВЕТ	ФИЗИЧЕСКОЕ СВОЙСТВО	ВЫШЕ
БОРДОВЫЙ ЦВЕТ	ФИЗИЧЕСКОЕ СВОЙСТВО	ВЫШЕ
БРАВУРНЫЙ	ФИЗИЧЕСКОЕ СВОЙСТВО	ВЫШЕ
БРОНЗОВЫЙ ЦВЕТ	ФИЗИЧЕСКОЕ СВОЙСТВО	ВЫШЕ
БУРЫЙ ЦВЕТ	ФИЗИЧЕСКОЕ СВОЙСТВО	ВЫШЕ
БУТЫЛОЧНЫЙ ЦВЕТ	ФИЗИЧЕСКОЕ СВОЙСТВО	ВЫШЕ
ВЕСЕЛЫЙ ПО ЦВЕТУ	ФИЗИЧЕСКОЕ СВОЙСТВО	ВЫШЕ
ВЕТРОВАЯ ЭНЕРГИЯ	ФИЗИЧЕСКОЕ СВОЙСТВО	ВЫШЕ
ВЕТХИЙ ОТ СТАРОСТИ	ФИЗИЧЕСКОЕ СВОЙСТВО	ВЫШЕ
ВИДИМЫЙ, ДОСТУПНЫЙ ЗРЕНИЮ	ФИЗИЧЕСКОЕ СВОЙСТВО	ВЫШЕ
ВИШНЕВЫЙ ЦВЕТ	ФИЗИЧЕСКОЕ СВОЙСТВО	ВЫШЕ
ВНЯТНЫЙ	ФИЗИЧЕСКОЕ СВОЙСТВО	ВЫШЕ
ВОДОНЕПРОНИЦАЕМЫЙ	ФИЗИЧЕСКОЕ СВОЙСТВО	ВЫШЕ
ВОДОПРОНИЦАЕМЫЙ	ФИЗИЧЕСКОЕ СВОЙСТВО	ВЫШЕ
ВОЗОБНОВЛЯЕМЫЕ ИСТОЧНИКИ ЭНЕРГИИ	ФИЗИЧЕСКОЕ СВОЙСТВО	ВЫШЕ
ВОЛНИСТЫЙ, ВОЛНООБРАЗНЫЙ	ФИЗИЧЕСКОЕ СВОЙСТВО	ВЫШЕ
ВЫДВИЖНОЙ, ВДВИЖНОЙ	ФИЗИЧЕСКОЕ СВОЙСТВО	ВЫШЕ
ВЯЗКИЙ (ЛИПКИЙ)	ФИЗИЧЕСКОЕ СВОЙСТВО	ВЫШЕ
ВЯЗКИЙ (ТОПКИЙ)	ФИЗИЧЕСКОЕ СВОЙСТВО	ВЫШЕ
ГАЗОНЕПРОНИЦАЕМЫЙ	ФИЗИЧЕСКОЕ СВОЙСТВО	ВЫШЕ
ГЕРМЕТИЧЕСКИЙ	ФИЗИЧЕСКОЕ СВОЙСТВО	ВЫШЕ
ГИБКИЙ (УПРУГИЙ)	ФИЗИЧЕСКОЕ СВОЙСТВО	ВЫШЕ
ГИДРОЭНЕРГИЯ	ФИЗИЧЕСКОЕ СВОЙСТВО	ВЫШЕ
ГЛЯНЕЦ (БЛЕСК ГЛАДКОЙ ПОВЕРХНОСТИ)	ФИЗИЧЕСКОЕ СВОЙСТВО	ВЫШЕ
ГНЕДАЯ МАСТЬ	ФИЗИЧЕСКОЕ СВОЙСТВО	ВЫШЕ
ГОЛУБОЙ ЦВЕТ	ФИЗИЧЕСКОЕ СВОЙСТВО	ВЫШЕ
ГОРЧИЧНЫЙ ЦВЕТ	ФИЗИЧЕСКОЕ СВОЙСТВО	ВЫШЕ
ГРАНАТОВЫЙ ЦВЕТ	ФИЗИЧЕСКОЕ СВОЙСТВО	ВЫШЕ
ГРОМКИЙ ПО ЗВУКУ	ФИЗИЧЕСКОЕ СВОЙСТВО	ВЫШЕ
ГРОМКОГОЛОСЫЙ	ФИЗИЧЕСКОЕ СВОЙСТВО	ВЫШЕ
ГРОМОГЛАСНЫЙ	ФИЗИЧЕСКОЕ СВОЙСТВО	ВЫШЕ
ГРУБЫЙ НА ОЩУПЬ	ФИЗИЧЕСКОЕ СВОЙСТВО	ВЫШЕ
ГУЛКИЙ ПО ЗВУКУ	ФИЗИЧЕСКОЕ СВОЙСТВО	ВЫШЕ
ГУСТОЙ ПО КОНСИСТЕНЦИИ	ФИЗИЧЕСКОЕ СВОЙСТВО	ВЫШЕ
ГУСТОЙ, ГУСТО РАСПОЛОЖЕННЫЙ	ФИЗИЧЕСКОЕ СВОЙСТВО	ВЫШЕ
ДВУСТОРОННИЙ (С ДВУМЯ РАВНОЦЕННЫМИ СТОРОНАМИ)	ФИЗИЧЕСКОЕ СВОЙСТВО	ВЫШЕ
ДОБРОТНЫЙ	ФИЗИЧЕСКОЕ СВОЙСТВО	ВЫШЕ
ДОЛГОВРЕМЕННЫЙ (ПРОЧНЫЙ)	ФИЗИЧЕСКОЕ СВОЙСТВО	ВЫШЕ
ДРЯБЛЫЙ, ВЯЛЫЙ	ФИЗИЧЕСКОЕ СВОЙСТВО	ВЫШЕ
ДРЯХЛЫЙ (СЛАБЫЙ, НЕМОЩНЫЙ ОТ СТАРОСТИ)	ФИЗИЧЕСКОЕ СВОЙСТВО	ВЫШЕ
ДЫРЧАТЫЙ	ФИЗИЧЕСКОЕ СВОЙСТВО	ВЫШЕ
ДЫРЯВЫЙ	ФИЗИЧЕСКОЕ СВОЙСТВО	ВЫШЕ
ЕДКИЙ, РАЗЪЕДАЮЩИЙ	ФИЗИЧЕСКОЕ СВОЙСТВО	ВЫШЕ
ЕСТЕСТВЕННОЕ ОСВЕЩЕНИЕ	ФИЗИЧЕСКОЕ СВОЙСТВО	ВЫШЕ
ЖАРОПРОЧНЫЙ	ФИЗИЧЕСКОЕ СВОЙСТВО	ВЫШЕ
ЖЕЛТЫЙ ЦВЕТ	ФИЗИЧЕСКОЕ СВОЙСТВО	ВЫШЕ
ЖЕМЧУЖНЫЙ ЦВЕТ	ФИЗИЧЕСКОЕ СВОЙСТВО	ВЫШЕ
ЖИДКИЙ (ИМЕЮЩИЙ СВОЙСТВО ТЕЧЬ)	ФИЗИЧЕСКОЕ СВОЙСТВО	ВЫШЕ
ЖИДКИЙ, ВОДЯНИСТЫЙ	ФИЗИЧЕСКОЕ СВОЙСТВО	ВЫШЕ
ЗАГАР	ФИЗИЧЕСКОЕ СВОЙСТВО	ВЫШЕ
ЗАГОРЕЛЫЙ	ФИЗИЧЕСКОЕ СВОЙСТВО	ВЫШЕ
ЗАКРЫТЫЙ СО ВСЕХ СТОРОН	ФИЗИЧЕСКОЕ СВОЙСТВО	ВЫШЕ
ЗАРЕВО	ФИЗИЧЕСКОЕ СВОЙСТВО	ВЫШЕ
ЗАРНИЦА, ОТБЛЕСК МОЛНИИ	ФИЗИЧЕСКОЕ СВОЙСТВО	ВЫШЕ
ЗАРЯ НА НЕБЕ	ФИЗИЧЕСКОЕ СВОЙСТВО	ВЫШЕ
ЗАЩИТНЫЙ ЦВЕТ	ФИЗИЧЕСКОЕ СВОЙСТВО	ВЫШЕ
ЗВОНКИЙ, ЗВУЧНЫЙ	ФИЗИЧЕСКОЕ СВОЙСТВО	ВЫШЕ
ЗЕЛЕНЫЙ (БЛЕДНЫЙ)	ФИЗИЧЕСКОЕ СВОЙСТВО	ВЫШЕ
ЗЕЛЕНЫЙ ЦВЕТ	ФИЗИЧЕСКОЕ СВОЙСТВО	ВЫШЕ
ЗЕМЛИСТЫЙ (СЕРОВАТО-БЛЕДНЫЙ)	ФИЗИЧЕСКОЕ СВОЙСТВО	ВЫШЕ
ЗОЛОТИСТЫЙ ЦВЕТ	ФИЗИЧЕСКОЕ СВОЙСТВО	ВЫШЕ
ЗЫЧНЫЙ	ФИЗИЧЕСКОЕ СВОЙСТВО	ВЫШЕ
ИЗВИЛИСТЫЙ (С ИЗВИЛИНАМИ)	ФИЗИЧЕСКОЕ СВОЙСТВО	ВЫШЕ
ИЗНОСОУСТОЙЧИВОСТЬ	ФИЗИЧЕСКОЕ СВОЙСТВО	ВЫШЕ
ИЗОБРАЗИТЕЛЬНЫЙ	ФИЗИЧЕСКОЕ СВОЙСТВО	ВЫШЕ
ИЗОГНУТЫЙ	ФИЗИЧЕСКОЕ СВОЙСТВО	ВЫШЕ
ИЗУМРУДНЫЙ ЦВЕТ	ФИЗИЧЕСКОЕ СВОЙСТВО	ВЫШЕ
ИСКУССТВЕННОЕ ОСВЕЩЕНИЕ	ФИЗИЧЕСКОЕ СВОЙСТВО	ВЫШЕ
КАРАМЕЛЬНЫЙ ЦВЕТ	ФИЗИЧЕСКОЕ СВОЙСТВО	ВЫШЕ
КАРИЙ ЦВЕТ	ФИЗИЧЕСКОЕ СВОЙСТВО	ВЫШЕ
КАРМАННОГО РАЗМЕРА	ФИЗИЧЕСКОЕ СВОЙСТВО	ВЫШЕ
КАШТАНОВЫЙ ЦВЕТ	ФИЗИЧЕСКОЕ СВОЙСТВО	ВЫШЕ
КИСЛЫЙ, ЗАКИСШИЙ	ФИЗИЧЕСКОЕ СВОЙСТВО	ВЫШЕ
КЛЕЙКИЙ	ФИЗИЧЕСКОЕ СВОЙСТВО	ВЫШЕ
КЛЕТЧАТЫЙ, В КЛЕТКУ	ФИЗИЧЕСКОЕ СВОЙСТВО	ВЫШЕ
КЛУБНИЧНЫЙ ЦВЕТ	ФИЗИЧЕСКОЕ СВОЙСТВО	ВЫШЕ
КОВКОСТЬ МЕТАЛЛА	ФИЗИЧЕСКОЕ СВОЙСТВО	ВЫШЕ
КОЛКИЙ (ПОДАТЛИВЫЙ)	ФИЗИЧЕСКОЕ СВОЙСТВО	ВЫШЕ
КОЛКИЙ, КОЛЮЧИЙ	ФИЗИЧЕСКОЕ СВОЙСТВО	ВЫШЕ
КОЛОТЬСЯ (ПОДДАВАТЬСЯ КОЛКЕ)	ФИЗИЧЕСКОЕ СВОЙСТВО	ВЫШЕ
КОМПАКТНЫЙ (ПЛОТНЫЙ)	ФИЗИЧЕСКОЕ СВОЙСТВО	ВЫШЕ
КОНСИСТЕНЦИЯ ВЕЩЕСТВА	ФИЗИЧЕСКОЕ СВОЙСТВО	ВЫШЕ
КОРАЛЛОВЫЙ ЦВЕТ	ФИЗИЧЕСКОЕ СВОЙСТВО	ВЫШЕ
КОРИЧНЕВЫЙ ЦВЕТ	ФИЗИЧЕСКОЕ СВОЙСТВО	ВЫШЕ
КОРЯВЫЙ (НЕРОВНЫЙ)	ФИЗИЧЕСКОЕ СВОЙСТВО	ВЫШЕ
КОФЕЙНЫЙ ЦВЕТ	ФИЗИЧЕСКОЕ СВОЙСТВО	ВЫШЕ
КРАСНЫЙ ЦВЕТ	ФИЗИЧЕСКОЕ СВОЙСТВО	ВЫШЕ
КРАХМАЛЬНЫЙ, НАКРАХМАЛЕННЫЙ	ФИЗИЧЕСКОЕ СВОЙСТВО	ВЫШЕ
КРЕМОВЫЙ ЦВЕТ	ФИЗИЧЕСКОЕ СВОЙСТВО	ВЫШЕ
КРЕПКИЙ, ПРОЧНЫЙ	ФИЗИЧЕСКОЕ СВОЙСТВО	ВЫШЕ
КРИВОЙ (ИЗОГНУТЫЙ)	ФИЗИЧЕСКОЕ СВОЙСТВО	ВЫШЕ
КРИКЛИВЫЙ (РЕЗКИЙ)	ФИЗИЧЕСКОЕ СВОЙСТВО	ВЫШЕ
КРИСТАЛЬНЫЙ (ПРОЗРАЧНЫЙ)	ФИЗИЧЕСКОЕ СВОЙСТВО	ВЫШЕ
КРИЧАЩЕ ЯРКИЙ	ФИЗИЧЕСКОЕ СВОЙСТВО	ВЫШЕ
КРОВАВЫЙ ЦВЕТ	ФИЗИЧЕСКОЕ СВОЙСТВО	ВЫШЕ
КРУТОЙ (ГУСТОЙ)	ФИЗИЧЕСКОЕ СВОЙСТВО	ВЫШЕ
ЛАЗУРНЫЙ ЦВЕТ	ФИЗИЧЕСКОЕ СВОЙСТВО	ВЫШЕ
ЛЕДЯНОЙ (ОЧЕНЬ ХОЛОДНЫЙ)	ФИЗИЧЕСКОЕ СВОЙСТВО	ВЫШЕ
ЛЕДЯНОЙ, ПОКРЫТЫЙ ЛЬДОМ	ФИЗИЧЕСКОЕ СВОЙСТВО	ВЫШЕ
ЛИМОННЫЙ ЦВЕТ	ФИЗИЧЕСКОЕ СВОЙСТВО	ВЫШЕ
ЛИПКИЙ	ФИЗИЧЕСКОЕ СВОЙСТВО	ВЫШЕ
ЛОМКИЙ, ХРУПКИЙ	ФИЗИЧЕСКОЕ СВОЙСТВО	ВЫШЕ
МАЛАХИТОВЫЙ ЦВЕТ	ФИЗИЧЕСКОЕ СВОЙСТВО	ВЫШЕ
МАЛИНОВЫЙ ЦВЕТ	ФИЗИЧЕСКОЕ СВОЙСТВО	ВЫШЕ
МАСТЬ ЖИВОТНОГО	ФИЗИЧЕСКОЕ СВОЙСТВО	ВЫШЕ
МАТОВЫЙ (НЕПРОЗРАЧНЫЙ)	ФИЗИЧЕСКОЕ СВОЙСТВО	ВЫШЕ
МЕДНЫЙ ЦВЕТ	ФИЗИЧЕСКОЕ СВОЙСТВО	ВЫШЕ
МЕРЗЛЫЙ (ЗАТВЕРДЕВШИЙ ОТ МОРОЗА)	ФИЗИЧЕСКОЕ СВОЙСТВО	ВЫШЕ
МЕТАЛЛИК (ЦВЕТ)	ФИЗИЧЕСКОЕ СВОЙСТВО	ВЫШЕ
МЕХАНИЧЕСКАЯ ВЯЗКОСТЬ	ФИЗИЧЕСКОЕ СВОЙСТВО	ВЫШЕ
МЕХАНИЧЕСКАЯ ПЛАСТИЧНОСТЬ	ФИЗИЧЕСКОЕ СВОЙСТВО	ВЫШЕ
МЕХАНИЧЕСКАЯ ПРОЧНОСТЬ	ФИЗИЧЕСКОЕ СВОЙСТВО	ВЫШЕ
МЕХАНИЧЕСКАЯ ТВЕРДОСТЬ	ФИЗИЧЕСКОЕ СВОЙСТВО	ВЫШЕ
МЕХАНИЧЕСКАЯ УПРУГОСТЬ	ФИЗИЧЕСКОЕ СВОЙСТВО	ВЫШЕ
МЕХАНИЧЕСКАЯ ХРУПКОСТЬ	ФИЗИЧЕСКОЕ СВОЙСТВО	ВЫШЕ
МЕХАНИЧЕСКОЕ СВОЙСТВО	ФИЗИЧЕСКОЕ СВОЙСТВО	ВЫШЕ
МИМИКРИЯ ОРГАНИЗМОВ	ФИЗИЧЕСКОЕ СВОЙСТВО	ВЫШЕ
МНОГОЦВЕТНЫЙ	ФИЗИЧЕСКОЕ СВОЙСТВО	ВЫШЕ
МОБИЛЬНЫЙ (ПЕРЕДВИЖНОЙ)	ФИЗИЧЕСКОЕ СВОЙСТВО	ВЫШЕ
МОЛОЧНЫЙ ЦВЕТ	ФИЗИЧЕСКОЕ СВОЙСТВО	ВЫШЕ
МОРКОВНЫЙ ЦВЕТ	ФИЗИЧЕСКОЕ СВОЙСТВО	ВЫШЕ
МОРОЗОСТОЙКИЙ	ФИЗИЧЕСКОЕ СВОЙСТВО	ВЫШЕ
МОРЩИНИСТЫЙ	ФИЗИЧЕСКОЕ СВОЙСТВО	ВЫШЕ
МРАМОРНАЯ ОКРАСКА	ФИЗИЧЕСКОЕ СВОЙСТВО	ВЫШЕ
МРАЧНЫЙ (ТЕМНЫЙ)	ФИЗИЧЕСКОЕ СВОЙСТВО	ВЫШЕ
МУТНЫЙ (НЕЧИСТЫЙ)	ФИЗИЧЕСКОЕ СВОЙСТВО	ВЫШЕ
МЫШИНЫЙ ЦВЕТ	ФИЗИЧЕСКОЕ СВОЙСТВО	ВЫШЕ
МЯГКИЙ ПРИ НАДАВЛИВАНИИ	ФИЗИЧЕСКОЕ СВОЙСТВО	ВЫШЕ
МЯГКИЙ, НЕЧЕРСТВЫЙ	ФИЗИЧЕСКОЕ СВОЙСТВО	ВЫШЕ
МЯТЫЙ, ЖЕВАНЫЙ	ФИЗИЧЕСКОЕ СВОЙСТВО	ВЫШЕ
НАВОРОЧЕННЫЙ (ХАРАКТЕРИСТИКА ИЗДЕЛИЯ)	ФИЗИЧЕСКОЕ СВОЙСТВО	ВЫШЕ
НАГЛЯДНЫЙ (ОСНОВАН.НА ПОКАЗЕ, СЛУЖ.ДЛЯ ПОКАЗА)	ФИЗИЧЕСКОЕ СВОЙСТВО	ВЫШЕ
НАДУВНОЙ	ФИЗИЧЕСКОЕ СВОЙСТВО	ВЫШЕ
НЕБЕСНЫЙ ЦВЕТ	ФИЗИЧЕСКОЕ СВОЙСТВО	ВЫШЕ
НЕГЛАДКИЙ (НЕРОВНЫЙ)	ФИЗИЧЕСКОЕ СВОЙСТВО	ВЫШЕ
НЕЗАМЕТНЫЙ НА ВЗГЛЯД	ФИЗИЧЕСКОЕ СВОЙСТВО	ВЫШЕ
НЕЗЫБЛЕМЫЙ (КРЕПКИЙ, УСТОЙЧИВЫЙ)	ФИЗИЧЕСКОЕ СВОЙСТВО	ВЫШЕ
НЕКРЕПКИЙ, НЕПРОЧНЫЙ	ФИЗИЧЕСКОЕ СВОЙСТВО	ВЫШЕ
НЕОЩУТИМЫЙ ОРГАНАМИ ЧУВСТВ	ФИЗИЧЕСКОЕ СВОЙСТВО	ВЫШЕ
НЕПРОЗРАЧНЫЙ НА ВИД	ФИЗИЧЕСКОЕ СВОЙСТВО	ВЫШЕ
НЕПРОНИЦАЕМЫЙ	ФИЗИЧЕСКОЕ СВОЙСТВО	ВЫШЕ
НЕПРОНИЦАЕМЫЙ ДЛЯ ЖИДКОСТИ	ФИЗИЧЕСКОЕ СВОЙСТВО	ВЫШЕ
НЕПРЯМОЙ (ЛИШЕННЫЙ ПРЯМИЗНЫ)	ФИЗИЧЕСКОЕ СВОЙСТВО	ВЫШЕ
НЕРЖАВЕЮЩИЙ	ФИЗИЧЕСКОЕ СВОЙСТВО	ВЫШЕ
НЕРОВНЫЙ ПО ПОВЕРХНОСТИ	ФИЗИЧЕСКОЕ СВОЙСТВО	ВЫШЕ
НЕТРАДИЦИОННЫЙ ВИД ЭНЕРГИИ	ФИЗИЧЕСКОЕ СВОЙСТВО	ВЫШЕ
НИМБ НАД ГОЛОВОЙ	ФИЗИЧЕСКОЕ СВОЙСТВО	ВЫШЕ
НОЗДРЕВАТЫЙ	ФИЗИЧЕСКОЕ СВОЙСТВО	ВЫШЕ
ОБОЗРИМЫЙ	ФИЗИЧЕСКОЕ СВОЙСТВО	ВЫШЕ
ОБРАЗНЫЙ (ИЗОБРАЗИТЕЛЬНЫЙ, ЯРКИЙ, ЖИВОЙ)	ФИЗИЧЕСКОЕ СВОЙСТВО	ВЫШЕ
ОГЛУШИТЕЛЬНЫЙ	ФИЗИЧЕСКОЕ СВОЙСТВО	ВЫШЕ
ОГНЕННЫЙ ЦВЕТ	ФИЗИЧЕСКОЕ СВОЙСТВО	ВЫШЕ
ОГНЕСТОЙКИЙ	ФИЗИЧЕСКОЕ СВОЙСТВО	ВЫШЕ
ОГОНЬ (СВЕТ ОТ ОСВЕТИТЕЛЬНЫХ ПРИБОРОВ)	ФИЗИЧЕСКОЕ СВОЙСТВО	ВЫШЕ
ОКРУЖНОЙ, ОКОЛЬНЫЙ	ФИЗИЧЕСКОЕ СВОЙСТВО	ВЫШЕ
ОЛИВКОВЫЙ ЦВЕТ	ФИЗИЧЕСКОЕ СВОЙСТВО	ВЫШЕ
ОПАЛОВЫЙ ЦВЕТ	ФИЗИЧЕСКОЕ СВОЙСТВО	ВЫШЕ
ОРАНЖЕВЫЙ ЦВЕТ	ФИЗИЧЕСКОЕ СВОЙСТВО	ВЫШЕ
ОСВЕЩЕНИЕ, СВЕТ ОТ ИСТОЧНИКА	ФИЗИЧЕСКОЕ СВОЙСТВО	ВЫШЕ
ОСНОВАТЕЛЬНЫЙ (КРЕПКИЙ, ПРОЧНЫЙ)	ФИЗИЧЕСКОЕ СВОЙСТВО	ВЫШЕ
ОСТРЫЙ (ОТТОЧЕННЫЙ)	ФИЗИЧЕСКОЕ СВОЙСТВО	ВЫШЕ
ОТБЛЕСК (БЛЕСК)	ФИЗИЧЕСКОЕ СВОЙСТВО	ВЫШЕ
ОТВЕРДЕЛЫЙ	ФИЗИЧЕСКОЕ СВОЙСТВО	ВЫШЕ
ОТВИСЛЫЙ	ФИЗИЧЕСКОЕ СВОЙСТВО	ВЫШЕ
ОТКРОВЕННЫЙ (СЛИШКОМ ОБНАЖАЮЩИЙ ТЕЛО)	ФИЗИЧЕСКОЕ СВОЙСТВО	ВЫШЕ
ОТКРЫТЫЙ, С БОЛЬШИМ ВЫРЕЗОМ	ФИЗИЧЕСКОЕ СВОЙСТВО	ВЫШЕ
ОТСВЕТ, ОТРАЖЕННЫЙ СВЕТ	ФИЗИЧЕСКОЕ СВОЙСТВО	ВЫШЕ
ПАСМУРНЫЙ (ХМУРЫЙ И СУМРАЧНЫЙ)	ФИЗИЧЕСКОЕ СВОЙСТВО	ВЫШЕ
ПЕПЕЛЬНЫЙ ЦВЕТ	ФИЗИЧЕСКОЕ СВОЙСТВО	ВЫШЕ
ПЕРЕДВИЖНОЙ, НЕСТАЦИОНАРНЫЙ	ФИЗИЧЕСКОЕ СВОЙСТВО	ВЫШЕ
ПЕРЕНОСНОЙ	ФИЗИЧЕСКОЕ СВОЙСТВО	ВЫШЕ
ПЕРЕСЕЧЕННОСТЬ МЕСТНОСТИ	ФИЗИЧЕСКОЕ СВОЙСТВО	ВЫШЕ
ПЕРЛАМУТРОВЫЙ ЦВЕТ	ФИЗИЧЕСКОЕ СВОЙСТВО	ВЫШЕ
ПЕРСИКОВЫЙ ЦВЕТ	ФИЗИЧЕСКОЕ СВОЙСТВО	ВЫШЕ
ПЕСОЧНЫЙ ЦВЕТ	ФИЗИЧЕСКОЕ СВОЙСТВО	ВЫШЕ
ПЛАВУЧЕСТЬ	ФИЗИЧЕСКОЕ СВОЙСТВО	ВЫШЕ
ПЛОТНЫЙ (ТОЛСТЫЙ И ПРОЧНЫЙ)	ФИЗИЧЕСКОЕ СВОЙСТВО	ВЫШЕ
ПЛОТНЫЙ ПО СОСТАВУ	ФИЗИЧЕСКОЕ СВОЙСТВО	ВЫШЕ
ПОДАВЛЕННЫЙ (ПРИГЛУШЕННЫЙ)	ФИЗИЧЕСКОЕ СВОЙСТВО	ВЫШЕ
ПОДАТЛИВОСТЬ МАТЕРИАЛА	ФИЗИЧЕСКОЕ СВОЙСТВО	ВЫШЕ
ПОДДАТЬСЯ ДЕЙСТВИЮ	ФИЗИЧЕСКОЕ СВОЙСТВО	ВЫШЕ
ПОЛОСАТАЯ ОКРАСКА	ФИЗИЧЕСКОЕ СВОЙСТВО	ВЫШЕ
ПОЛУПРОЗРАЧНЫЙ	ФИЗИЧЕСКОЕ СВОЙСТВО	ВЫШЕ
ПОЛУСВЕТ (СЛАБЫЙ СВЕТ)	ФИЗИЧЕСКОЕ СВОЙСТВО	ВЫШЕ
ПОРИСТЫЙ	ФИЗИЧЕСКОЕ СВОЙСТВО	ВЫШЕ
ПОРТАТИВНЫЙ	ФИЗИЧЕСКОЕ СВОЙСТВО	ВЫШЕ
ПРАЗДНИЧНАЯ ИЛЛЮМИНАЦИЯ	ФИЗИЧЕСКОЕ СВОЙСТВО	ВЫШЕ
ПРИГЛУШЕННЫЙ (ТИХИЙ)	ФИЗИЧЕСКОЕ СВОЙСТВО	ВЫШЕ
ПРИМЕТНЫЙ (ВИДИМЫЙ)	ФИЗИЧЕСКОЕ СВОЙСТВО	ВЫШЕ
ПРОБЛЕСК СВЕТА	ФИЗИЧЕСКОЕ СВОЙСТВО	ВЫШЕ
ПРОВОДИМОСТЬ (ФИЗИЧЕСКОЕ СВОЙСТВО)	ФИЗИЧЕСКОЕ СВОЙСТВО	ВЫШЕ
ПРОЗРАЧНЫЙ НА ВИД	ФИЗИЧЕСКОЕ СВОЙСТВО	ВЫШЕ
ПРОНИЦАЕМЫЙ	ФИЗИЧЕСКОЕ СВОЙСТВО	ВЫШЕ
ПРОХЛАДНЫЙ (НЕ ЖАРКИЙ)	ФИЗИЧЕСКОЕ СВОЙСТВО	ВЫШЕ
ПРЫЩАВЫЙ	ФИЗИЧЕСКОЕ СВОЙСТВО	ВЫШЕ
ПУЛЕНЕПРОБИВАЕМЫЙ	ФИЗИЧЕСКОЕ СВОЙСТВО	ВЫШЕ
ПУРПУР (КРАСНЫЙ ЦВЕТ)	ФИЗИЧЕСКОЕ СВОЙСТВО	ВЫШЕ
ПУХЛЫЙ (ОКРУГЛЫЙ И МЯГКИЙ)	ФИЗИЧЕСКОЕ СВОЙСТВО	ВЫШЕ
ПУШИСТЫЙ (МЯГКИЙ, ЛЕГКИЙ)	ФИЗИЧЕСКОЕ СВОЙСТВО	ВЫШЕ
ПШЕНИЧНЫЙ ЦВЕТ	ФИЗИЧЕСКОЕ СВОЙСТВО	ВЫШЕ
ПЫШНЫЙ (ЛЕГКИЙ, КАК БЫ ВЗБИТЫЙ; ПУШИСТЫЙ)	ФИЗИЧЕСКОЕ СВОЙСТВО	ВЫШЕ
РАЗНОЦВЕТНЫЙ	ФИЗИЧЕСКОЕ СВОЙСТВО	ВЫШЕ
РАСПИСНОЙ (КРАСОЧНЫЙ)	ФИЗИЧЕСКОЕ СВОЙСТВО	ВЫШЕ
РАССЫПЧАТЫЙ (ЛЕГКО РАЗРУШАЮЩИЙСЯ)	ФИЗИЧЕСКОЕ СВОЙСТВО	ВЫШЕ
РАСТВОРИМОСТЬ	ФИЗИЧЕСКОЕ СВОЙСТВО	ВЫШЕ
РАСТЯЖИМОСТЬ (МЕХАНИЧЕСКОЕ СВОЙСТВО)	ФИЗИЧЕСКОЕ СВОЙСТВО	ВЫШЕ
РВАНЫЙ, ДРАНЫЙ	ФИЗИЧЕСКОЕ СВОЙСТВО	ВЫШЕ
РЕБРИСТЫЙ	ФИЗИЧЕСКОЕ СВОЙСТВО	ВЫШЕ
РЕДКИЙ, НЕПЛОТНЫЙ	ФИЗИЧЕСКОЕ СВОЙСТВО	ВЫШЕ
РЕДКИЙ, РЕДКО РАСПОЛОЖЕННЫЙ	ФИЗИЧЕСКОЕ СВОЙСТВО	ВЫШЕ
РЕЗКИЙ ПО ЦВЕТУ	ФИЗИЧЕСКОЕ СВОЙСТВО	ВЫШЕ
РЕЗНОЙ (НЕРОВНЫЙ)	ФИЗИЧЕСКОЕ СВОЙСТВО	ВЫШЕ
РЕЗОНАНС
РЖАВЧИНА
РУМЯНОСТЬ
РЫХЛЫЙ (ДРЯБЛЫЙ)	ФИЗИЧЕСКОЕ СВОЙСТВО	ВЫШЕ
РЫХЛЫЙ (НЕПЛОТНЫЙ, РАССЫПЧАТЫЙ)	ФИЗИЧЕСКОЕ СВОЙСТВО	ВЫШЕ
РЯБИНОВЫЙ ЦВЕТ	ФИЗИЧЕСКОЕ СВОЙСТВО	ВЫШЕ
РЯБОЙ (ПЕСТРЫЙ)	ФИЗИЧЕСКОЕ СВОЙСТВО	ВЫШЕ
САЛАТОВЫЙ ЦВЕТ	ФИЗИЧЕСКОЕ СВОЙСТВО	ВЫШЕ
САПФИРОВЫЙ ЦВЕТ	ФИЗИЧЕСКОЕ СВОЙСТВО	ВЫШЕ
СВЕКОЛЬНЫЙ ЦВЕТ	ФИЗИЧЕСКОЕ СВОЙСТВО	ВЫШЕ
СВЕРХПРОВОДИМОСТЬ	ФИЗИЧЕСКОЕ СВОЙСТВО	ВЫШЕ
СВЕТ (ЛУЧИСТАЯ ЭНЕРГИЯ)	ФИЗИЧЕСКОЕ СВОЙСТВО	ВЫШЕ
СВЕТЛЫЙ ПО ЦВЕТУ	ФИЗИЧЕСКОЕ СВОЙСТВО	ВЫШЕ
СВИНЦОВЫЙ ЦВЕТ	ФИЗИЧЕСКОЕ СВОЙСТВО	ВЫШЕ
СЕДОЙ, СЕДОВЛАСЫЙ	ФИЗИЧЕСКОЕ СВОЙСТВО	ВЫШЕ
СЕРЕБРЯНЫЙ (МЕЛОДИЧНО-ЗВОНКИЙ)	ФИЗИЧЕСКОЕ СВОЙСТВО	ВЫШЕ
СЕРЕБРЯНЫЙ ЦВЕТ	ФИЗИЧЕСКОЕ СВОЙСТВО	ВЫШЕ
СЕРЫЙ ЦВЕТ	ФИЗИЧЕСКОЕ СВОЙСТВО	ВЫШЕ
СЖИЖЕННЫЙ (ЖИДКИЙ)	ФИЗИЧЕСКОЕ СВОЙСТВО	ВЫШЕ
СИВАЯ МАСТЬ	ФИЗИЧЕСКОЕ СВОЙСТВО	ВЫШЕ
СИЗЫЙ ЦВЕТ	ФИЗИЧЕСКОЕ СВОЙСТВО	ВЫШЕ
СИНИЙ ЦВЕТ	ФИЗИЧЕСКОЕ СВОЙСТВО	ВЫШЕ
СИРЕНЕВЫЙ ЦВЕТ	ФИЗИЧЕСКОЕ СВОЙСТВО	ВЫШЕ
СИЯНИЕ СВЕТА	ФИЗИЧЕСКОЕ СВОЙСТВО	ВЫШЕ
СКАНДАЛЬНЫЙ ПО ХАРАКТЕРУ	ФИЗИЧЕСКОЕ СВОЙСТВО	ВЫШЕ
СКВОЗНОЙ (НЕПЛОТНЫЙ)	ФИЗИЧЕСКОЕ СВОЙСТВО	ВЫШЕ
СКЛАДНОЙ	ФИЗИЧЕСКОЕ СВОЙСТВО	ВЫШЕ
СЛАБЫЙ, НЕТУГОЙ	ФИЗИЧЕСКОЕ СВОЙСТВО	ВЫШЕ
СЛЫШНЫЙ, ДОСТУПНЫЙ СЛУХУ	ФИЗИЧЕСКОЕ СВОЙСТВО	ВЫШЕ
СМЕННЫЙ (ХАРАКТЕРИСТИКА ИЗДЕЛИЯ)	ФИЗИЧЕСКОЕ СВОЙСТВО	ВЫШЕ
СМУГЛЫЙ	ФИЗИЧЕСКОЕ СВОЙСТВО	ВЫШЕ
СОЛНЕЧНАЯ ЭНЕРГИЯ	ФИЗИЧЕСКОЕ СВОЙСТВО	ВЫШЕ
СОЛНЕЧНЫЙ СВЕТ	ФИЗИЧЕСКОЕ СВОЙСТВО	ВЫШЕ
СОЛОВАЯ МАСТЬ	ФИЗИЧЕСКОЕ СВОЙСТВО	ВЫШЕ
СОЛОМЕННЫЙ ЦВЕТ	ФИЗИЧЕСКОЕ СВОЙСТВО	ВЫШЕ
СОЧНЫЙ ПО ЦВЕТУ	ФИЗИЧЕСКОЕ СВОЙСТВО	ВЫШЕ
СТАЛЬНОЙ ЦВЕТ	ФИЗИЧЕСКОЕ СВОЙСТВО	ВЫШЕ
СУМРАЧНЫЙ (ОХВАЧЕННЫЙ СУМРАКОМ)	ФИЗИЧЕСКОЕ СВОЙСТВО	ВЫШЕ
СУТУЛЫЙ (СОГНУТЫЙ, НЕПРЯМОЙ)	ФИЗИЧЕСКОЕ СВОЙСТВО	ВЫШЕ
СЪЕМНЫЙ	ФИЗИЧЕСКОЕ СВОЙСТВО	ВЫШЕ
ТАЛЫЙ	ФИЗИЧЕСКОЕ СВОЙСТВО	ВЫШЕ
ТВЕРДЫЙ, НЕМЯГКИЙ	ФИЗИЧЕСКОЕ СВОЙСТВО	ВЫШЕ
ТЕЛЕСНЫЙ ЦВЕТ	ФИЗИЧЕСКОЕ СВОЙСТВО	ВЫШЕ
ТЕМНО-КРАСНЫЙ ЦВЕТ	ФИЗИЧЕСКОЕ СВОЙСТВО	ВЫШЕ
ТЕМНО-СИНИЙ ЦВЕТ	ФИЗИЧЕСКОЕ СВОЙСТВО	ВЫШЕ
ТЕМНЫЙ ПО ЦВЕТУ	ФИЗИЧЕСКОЕ СВОЙСТВО	ВЫШЕ
ТЕПЛОВАЯ ЭНЕРГИЯ	ФИЗИЧЕСКОЕ СВОЙСТВО	ВЫШЕ
ТЕПЛОПРОВОДНОСТЬ	ФИЗИЧЕСКОЕ СВОЙСТВО	ВЫШЕ
ТЕПЛЫЙ ПО ЦВЕТУ	ФИЗИЧЕСКОЕ СВОЙСТВО	ВЫШЕ
ТЕРМОСТОЙКОСТЬ	ФИЗИЧЕСКОЕ СВОЙСТВО	ВЫШЕ
ТЕРМОЯДЕРНАЯ ЭНЕРГИЯ	ФИЗИЧЕСКОЕ СВОЙСТВО	ВЫШЕ
ТЕСНЫЙ, ТЕСНО РАСПОЛОЖЕННЫЙ	ФИЗИЧЕСКОЕ СВОЙСТВО	ВЫШЕ
ТИГРОВЫЙ (ПОЛОСАТЫЙ)	ФИЗИЧЕСКОЕ СВОЙСТВО	ВЫШЕ
ТИХИЙ, НЕГРОМКИЙ	ФИЗИЧЕСКОЕ СВОЙСТВО	ВЫШЕ
ТОРОСИСТЫЙ	ФИЗИЧЕСКОЕ СВОЙСТВО	ВЫШЕ
ТРЕХЦВЕТНЫЙ	ФИЗИЧЕСКОЕ СВОЙСТВО	ВЫШЕ
ТУГОЙ (С ТРУДОМ ПОДДАЮЩИЙСЯ ВОЗДЕЙСТВИЮ)	ФИЗИЧЕСКОЕ СВОЙСТВО	ВЫШЕ
ТУГОЙ, ТУГО НАТЯНУТЫЙ	ФИЗИЧЕСКОЕ СВОЙСТВО	ВЫШЕ
ТУПОЙ, НЕОСТРЫЙ	ФИЗИЧЕСКОЕ СВОЙСТВО	ВЫШЕ
ТЯГУЧИЙ (ГУСТОЙ, ТЯНУЩИЙСЯ)	ФИЗИЧЕСКОЕ СВОЙСТВО	ВЫШЕ
УГЛОВАТЫЙ (НЕРОВНЫЙ)	ФИЗИЧЕСКОЕ СВОЙСТВО	ВЫШЕ
УЗОРЧАТЫЙ, С УЗОРОМ	ФИЗИЧЕСКОЕ СВОЙСТВО	ВЫШЕ
УЛИЧНОЕ ОСВЕЩЕНИЕ	ФИЗИЧЕСКОЕ СВОЙСТВО	ВЫШЕ
УПРУГИЙ (ТВЕРДЫЙ, НО ПОДАТЛИВЫЙ НА СЖАТИЕ)	ФИЗИЧЕСКОЕ СВОЙСТВО	ВЫШЕ
УСТОЙЧИВОСТЬ К ВЫСОКИМ ТЕМПЕРАТУРАМ	ФИЗИЧЕСКОЕ СВОЙСТВО	ВЫШЕ
УСТОЙЧИВЫЙ, УСТОЙЧИВО СТОЯЩИЙ	ФИЗИЧЕСКОЕ СВОЙСТВО	ВЫШЕ
УХАБИСТЫЙ, С УХАБАМИ	ФИЗИЧЕСКОЕ СВОЙСТВО	ВЫШЕ
ФИЗИЧЕСКОЕ СВОЙСТВО	ФИЗИЧЕСКОЕ СВОЙСТВО	ВЫШЕ
ФИОЛЕТОВЫЙ ЦВЕТ	ФИЗИЧЕСКОЕ СВОЙСТВО	ВЫШЕ
ФУНДАМЕНТАЛЬНЫЙ (КРЕПКИЙ)	ФИЗИЧЕСКОЕ СВОЙСТВО	ВЫШЕ
ХАРАКТЕРИСТИКА ИЗДЕЛИЯ	ФИЗИЧЕСКОЕ СВОЙСТВО	ВЫШЕ
ХОЛОДНЫЙ ПО ТЕМПЕРАТУРЕ	ФИЗИЧЕСКОЕ СВОЙСТВО	ВЫШЕ
ХОЛОДНЫЙ ПО ЦВЕТУ	ФИЗИЧЕСКОЕ СВОЙСТВО	ВЫШЕ
ХРУСТАЛЬНЫЙ (ЗВОНКИЙ)	ФИЗИЧЕСКОЕ СВОЙСТВО	ВЫШЕ
ЦВЕТ ВОЛОС	ФИЗИЧЕСКОЕ СВОЙСТВО	ВЫШЕ
ЦВЕТ ГЛАЗ	ФИЗИЧЕСКОЕ СВОЙСТВО	ВЫШЕ
ЦВЕТ ИНДИГО	ФИЗИЧЕСКОЕ СВОЙСТВО	ВЫШЕ
ЦВЕТ ЛИЦА	ФИЗИЧЕСКОЕ СВОЙСТВО	ВЫШЕ
ЦВЕТ ТРАВЫ	ФИЗИЧЕСКОЕ СВОЙСТВО	ВЫШЕ
ЦВЕТ ФОНА	ФИЗИЧЕСКОЕ СВОЙСТВО	ВЫШЕ
ЦВЕТ, ОКРАСКА	ФИЗИЧЕСКОЕ СВОЙСТВО	ВЫШЕ
ЦВЕТАСТЫЙ	ФИЗИЧЕСКОЕ СВОЙСТВО	ВЫШЕ
ЦВЕТНОЙ (НЕ ЧЕРНЫЙ И НЕ БЕЛЫЙ)	ФИЗИЧЕСКОЕ СВОЙСТВО	ВЫШЕ
ЧЕРНО-БЕЛЫЙ	ФИЗИЧЕСКОЕ СВОЙСТВО	ВЫШЕ
ЧЕРНОВОЛОСЫЙ	ФИЗИЧЕСКОЕ СВОЙСТВО	ВЫШЕ
ЧЕРНЫЙ ЦВЕТ	ФИЗИЧЕСКОЕ СВОЙСТВО	ВЫШЕ
ЧЕРСТВЫЙ (ЗАСОХШИЙ)	ФИЗИЧЕСКОЕ СВОЙСТВО	ВЫШЕ
ШАТКИЙ, НЕУСТОЙЧИВЫЙ	ФИЗИЧЕСКОЕ СВОЙСТВО	ВЫШЕ
ШЕРОХОВАТОСТЬ ПОВЕРХНОСТИ	ФИЗИЧЕСКОЕ СВОЙСТВО	ВЫШЕ
ШОКОЛАДНЫЙ ЦВЕТ	ФИЗИЧЕСКОЕ СВОЙСТВО	ВЫШЕ
ЭЛАСТИЧНОСТЬ МАТЕРИАЛА	ФИЗИЧЕСКОЕ СВОЙСТВО	ВЫШЕ
ЭЛЕКТРИЧЕСКАЯ ЭНЕРГИЯ	ФИЗИЧЕСКОЕ СВОЙСТВО	ВЫШЕ
ЭЛЕКТРООТРИЦАТЕЛЬНОСТЬ	ФИЗИЧЕСКОЕ СВОЙСТВО	ВЫШЕ
ЭЛЕКТРОПОЛОЖИТЕЛЬНОСТЬ	ФИЗИЧЕСКОЕ СВОЙСТВО	ВЫШЕ
ЭЛЕКТРОПРОВОДНОСТЬ	ФИЗИЧЕСКОЕ СВОЙСТВО	ВЫШЕ
ЭНЕРГЕТИЧЕСКИЕ РЕСУРСЫ	ФИЗИЧЕСКОЕ СВОЙСТВО	ВЫШЕ
ЭНЕРГИЯ	ФИЗИЧЕСКОЕ СВОЙСТВО	ВЫШЕ
ЯНТАРНЫЙ ЦВЕТ	ФИЗИЧЕСКОЕ СВОЙСТВО	ВЫШЕ
ЯРКИЙ ПО ЦВЕТУ	ФИЗИЧЕСКОЕ СВОЙСТВО	ВЫШЕАЛАТАУ	ФОРМА, НАРУЖНЫЙ ВИД	ВЫШЕ
АЛТАЙ	ФОРМА, НАРУЖНЫЙ ВИД	ВЫШЕ
АЛЬПЫ	ФОРМА, НАРУЖНЫЙ ВИД	ВЫШЕ
АНДЫ	ФОРМА, НАРУЖНЫЙ ВИД	ВЫШЕ
АПЕННИНЫ	ФОРМА, НАРУЖНЫЙ ВИД	ВЫШЕ
АППАЛАЧИ	ФОРМА, НАРУЖНЫЙ ВИД	ВЫШЕ
АТЛЕТИЧЕСКИЙ, АТЛЕТИЧЕСКОГО ТЕЛОСЛОЖЕНИЯ	ФОРМА, НАРУЖНЫЙ ВИД	ВЫШЕ
АФАР	ФОРМА, НАРУЖНЫЙ ВИД	ВЫШЕ
БЕКАА	ФОРМА, НАРУЖНЫЙ ВИД	ВЫШЕ
БЕЛУДЖИСТАН	ФОРМА, НАРУЖНЫЙ ВИД	ВЫШЕ
ВЕЕРООБРАЗНЫЙ	ФОРМА, НАРУЖНЫЙ ВИД	ВЫШЕ
ВОГНУТАЯ ФОРМА	ФОРМА, НАРУЖНЫЙ ВИД	ВЫШЕ
ВОЛНИСТЫЙ, ВОЛНООБРАЗНЫЙ	ФОРМА, НАРУЖНЫЙ ВИД	ВЫШЕ
ВОРОНКООБРАЗНАЯ ФОРМА	ФОРМА, НАРУЖНЫЙ ВИД	ВЫШЕ
ВПАДИНА (ГЕОГРАФИЧЕСКИЙ ОБЪЕКТ)	ФОРМА, НАРУЖНЫЙ ВИД	ВЫШЕ
ВПАЛЫЙ	ФОРМА, НАРУЖНЫЙ ВИД	ВЫШЕ
ВЫПУКЛАЯ ФОРМА	ФОРМА, НАРУЖНЫЙ ВИД	ВЫШЕ
ВЫПУКЛЫЙ, РЕЛЬЕФНЫЙ	ФОРМА, НАРУЖНЫЙ ВИД	ВЫШЕ
ВЫСОКОГОРНАЯ МЕСТНОСТЬ	ФОРМА, НАРУЖНЫЙ ВИД	ВЫШЕ
ГЕОМЕТРИЧЕСКОЕ ТЕЛО	ФОРМА, НАРУЖНЫЙ ВИД	ВЫШЕ
ГИМАЛАИ	ФОРМА, НАРУЖНЫЙ ВИД	ВЫШЕ
ГИНДУКУШ	ФОРМА, НАРУЖНЫЙ ВИД	ВЫШЕ
ГЛАДКИЙ НА ОЩУПЬ	ФОРМА, НАРУЖНЫЙ ВИД	ВЫШЕ
ГОЛАНСКИЕ ВЫСОТЫ	ФОРМА, НАРУЖНЫЙ ВИД	ВЫШЕ
ГОРНАЯ МЕСТНОСТЬ	ФОРМА, НАРУЖНЫЙ ВИД	ВЫШЕ
ГОРНЫЙ ЛАНДШАФТ	ФОРМА, НАРУЖНЫЙ ВИД	ВЫШЕ
ГОРНЫЙ МАССИВ	ФОРМА, НАРУЖНЫЙ ВИД	ВЫШЕ
ГРАФИКА (НАЧЕРТАНИЯ ГРАФИЧЕСКИХ ЗНАКОВ)	ФОРМА, НАРУЖНЫЙ ВИД	ВЫШЕ
ГРАЦИОЗНЫЙ	ФОРМА, НАРУЖНЫЙ ВИД	ВЫШЕ
ДОЛГОВЯЗЫЙ	ФОРМА, НАРУЖНЫЙ ВИД	ВЫШЕ
ДОЛИНА	ФОРМА, НАРУЖНЫЙ ВИД	ВЫШЕ
ЖИГУЛИ	ФОРМА, НАРУЖНЫЙ ВИД	ВЫШЕ
ЗАВИВКА (ПРИЧЕСКА)	ФОРМА, НАРУЖНЫЙ ВИД	ВЫШЕ
ЗЕРКАЛЬНЫЙ (ГЛАДКИЙ И БЛЕСТЯЩИЙ)	ФОРМА, НАРУЖНЫЙ ВИД	ВЫШЕ
ЗИГЗАГООБРАЗНЫЙ	ФОРМА, НАРУЖНЫЙ ВИД	ВЫШЕ
ИЗВИЛИСТЫЙ (С ИЗВИЛИНАМИ)	ФОРМА, НАРУЖНЫЙ ВИД	ВЫШЕ
ИЗОГНУТЫЙ	ФОРМА, НАРУЖНЫЙ ВИД	ВЫШЕ
КАНЬОН	ФОРМА, НАРУЖНЫЙ ВИД	ВЫШЕ
КВАДРАТНАЯ ФОРМА	ФОРМА, НАРУЖНЫЙ ВИД	ВЫШЕ
КЛЕШ (ПОКРОЙ)	ФОРМА, НАРУЖНЫЙ ВИД	ВЫШЕ
КЛИНОВИДНАЯ ФОРМА	ФОРМА, НАРУЖНЫЙ ВИД	ВЫШЕ
КОНТУР, ВНЕШНЕЕ ОЧЕРТАНИЕ	ФОРМА, НАРУЖНЫЙ ВИД	ВЫШЕ
КОНУС (ГЕОМЕТРИЧЕСКОЕ ТЕЛО)	ФОРМА, НАРУЖНЫЙ ВИД	ВЫШЕ
КОНУСООБРАЗНЫЙ	ФОРМА, НАРУЖНЫЙ ВИД	ВЫШЕ
КОНФИГУРАЦИЯ (ФОРМА, ОЧЕРТАНИЕ)	ФОРМА, НАРУЖНЫЙ ВИД	ВЫШЕ
КОСА ВОЛОС	ФОРМА, НАРУЖНЫЙ ВИД	ВЫШЕ
КОТЛОВИНА	ФОРМА, НАРУЖНЫЙ ВИД	ВЫШЕ
КРЕСТООБРАЗНЫЙ (ФОРМА)	ФОРМА, НАРУЖНЫЙ ВИД	ВЫШЕ
КРИВОЙ (ИЗОГНУТЫЙ)	ФОРМА, НАРУЖНЫЙ ВИД	ВЫШЕ
КРУГЛАЯ ФОРМА	ФОРМА, НАРУЖНЫЙ ВИД	ВЫШЕ
КУБИЧЕСКАЯ ФОРМА	ФОРМА, НАРУЖНЫЙ ВИД	ВЫШЕ
КУРСИВ	ФОРМА, НАРУЖНЫЙ ВИД	ВЫШЕ
ЛАНДШАФТ	ФОРМА, НАРУЖНЫЙ ВИД	ВЫШЕ
МАНТИЯ ЗЕМЛИ	ФОРМА, НАРУЖНЫЙ ВИД	ВЫШЕ
МАТЕРЫЙ (ЗРЕЛЫЙ)	ФОРМА, НАРУЖНЫЙ ВИД	ВЫШЕ
МИНДАЛЕВИДНАЯ ФОРМА	ФОРМА, НАРУЖНЫЙ ВИД	ВЫШЕ
МНОГОГРАННИК	ФОРМА, НАРУЖНЫЙ ВИД	ВЫШЕ
НАГОРЬЕ	ФОРМА, НАРУЖНЫЙ ВИД	ВЫШЕ
НАПИСАНИЕ БУКВЫ	ФОРМА, НАРУЖНЫЙ ВИД	ВЫШЕ
НАЧЕРТАНИЕ (ФОРМА ИЗОБРАЖЕНИЯ)	ФОРМА, НАРУЖНЫЙ ВИД	ВЫШЕ
НЕПРАВИЛЬНАЯ ФОРМА	ФОРМА, НАРУЖНЫЙ ВИД	ВЫШЕ
НЕСКЛАДНО СЛОЖЕННЫЙ	ФОРМА, НАРУЖНЫЙ ВИД	ВЫШЕ
НИЗМЕННОСТЬ (РАВНИНА)	ФОРМА, НАРУЖНЫЙ ВИД	ВЫШЕ
ОВАЛ	ФОРМА, НАРУЖНЫЙ ВИД	ВЫШЕ
ОГРАНКА (ФОРМА)	ФОРМА, НАРУЖНЫЙ ВИД	ВЫШЕ
ОКРУГЛАЯ ФОРМА	ФОРМА, НАРУЖНЫЙ ВИД	ВЫШЕ
ОЛИМП	ФОРМА, НАРУЖНЫЙ ВИД	ВЫШЕ
ПАМИР	ФОРМА, НАРУЖНЫЙ ВИД	ВЫШЕ
ПИРАМИДА (ГЕОМЕТРИЧЕСКОЕ ТЕЛО)	ФОРМА, НАРУЖНЫЙ ВИД	ВЫШЕ
ПИРАМИДАЛЬНЫЙ	ФОРМА, НАРУЖНЫЙ ВИД	ВЫШЕ
ПИРЕНЕИ	ФОРМА, НАРУЖНЫЙ ВИД	ВЫШЕ
ПЛАТО	ФОРМА, НАРУЖНЫЙ ВИД	ВЫШЕ
ПЛОСКИЙ, НЕРЕЛЬЕФНЫЙ	ФОРМА, НАРУЖНЫЙ ВИД	ВЫШЕ
ПЛОСКОГОРЬЕ	ФОРМА, НАРУЖНЫЙ ВИД	ВЫШЕ
ПОКРОЙ ОДЕЖДЫ	ФОРМА, НАРУЖНЫЙ ВИД	ВЫШЕ
ПОЛУКРУГ	ФОРМА, НАРУЖНЫЙ ВИД	ВЫШЕ
ПРАВИЛЬНЫЙ ПО ФОРМЕ	ФОРМА, НАРУЖНЫЙ ВИД	ВЫШЕ
ПРИЗМА (МНОГОГРАННИК)	ФОРМА, НАРУЖНЫЙ ВИД	ВЫШЕ
ПРИЧЕСКА (ФОРМА ВОЛОС)	ФОРМА, НАРУЖНЫЙ ВИД	ВЫШЕ
ПРОДОЛГОВАТЫЙ	ФОРМА, НАРУЖНЫЙ ВИД	ВЫШЕ
ПРЯМОЙ, БЕЗ ИЗГИБОВ	ФОРМА, НАРУЖНЫЙ ВИД	ВЫШЕ
ПРЯМОУГОЛЬНАЯ ФОРМА	ФОРМА, НАРУЖНЫЙ ВИД	ВЫШЕ
ПУХЛЫЙ (ОКРУГЛЫЙ И МЯГКИЙ)	ФОРМА, НАРУЖНЫЙ ВИД	ВЫШЕ
ПУЧОК (ПРИЧЕСКА)	ФОРМА, НАРУЖНЫЙ ВИД	ВЫШЕ
РАВНИНА	ФОРМА, НАРУЖНЫЙ ВИД	ВЫШЕ
РАВНИННЫЙ ЛАНДШАФТ	ФОРМА, НАРУЖНЫЙ ВИД	ВЫШЕ
РЕГУЛЯРНЫЙ ПО ФОРМЕ	ФОРМА, НАРУЖНЫЙ ВИД	ВЫШЕ
РЕЛЬЕФ ПОВЕРХНОСТИ	ФОРМА, НАРУЖНЫЙ ВИД	ВЫШЕ
РОВНЫЙ ПО ПОВЕРХНОСТИ	ФОРМА, НАРУЖНЫЙ ВИД	ВЫШЕ
РОГОВИДНЫЙ	ФОРМА, НАРУЖНЫЙ ВИД	ВЫШЕ
РОМБОВИДНАЯ ФОРМА	ФОРМА, НАРУЖНЫЙ ВИД	ВЫШЕ
САВАННА	ФОРМА, НАРУЖНЫЙ ВИД	ВЫШЕ
САФАРИ (ОДЕЖДА)	ФОРМА, НАРУЖНЫЙ ВИД	ВЫШЕ
САЯНЫ	ФОРМА, НАРУЖНЫЙ ВИД	ВЫШЕ
СИЛУЭТ (ОЧЕРТАНИЯ В ТЕМНОТЕ, ТУМАНЕ)	ФОРМА, НАРУЖНЫЙ ВИД	ВЫШЕ
СИХОТЭ-АЛИНЬ	ФОРМА, НАРУЖНЫЙ ВИД	ВЫШЕ
СКЛАДНЫЙ, ХОРОШО СЛОЖЕННЫЙ	ФОРМА, НАРУЖНЫЙ ВИД	ВЫШЕ
СКОЛЬЗКИЙ (ГЛАДКИЙ)	ФОРМА, НАРУЖНЫЙ ВИД	ВЫШЕ
СПИРАЛЕВИДНАЯ ФОРМА	ФОРМА, НАРУЖНЫЙ ВИД	ВЫШЕ
СТАТНЫЙ	ФОРМА, НАРУЖНЫЙ ВИД	ВЫШЕ
СТЕПЬ	ФОРМА, НАРУЖНЫЙ ВИД	ВЫШЕ
СТРЕЛОВИДНЫЙ	ФОРМА, НАРУЖНЫЙ ВИД	ВЫШЕ
СТРИЖКА (ПРИЧЕСКА)	ФОРМА, НАРУЖНЫЙ ВИД	ВЫШЕ
СТРИЖКА КАРЕ	ФОРМА, НАРУЖНЫЙ ВИД	ВЫШЕ
СТРИЖКА ПОД БОКС	ФОРМА, НАРУЖНЫЙ ВИД	ВЫШЕ
СТРИЖКА ПОД ЕЖИК	ФОРМА, НАРУЖНЫЙ ВИД	ВЫШЕ
СТРОЙНЫЙ (ХОРОШО СЛОЖЕННЫЙ)	ФОРМА, НАРУЖНЫЙ ВИД	ВЫШЕ
СТРОЙНЫЙ, ПРАВИЛЬНО РАСПОЛОЖЕННЫЙ	ФОРМА, НАРУЖНЫЙ ВИД	ВЫШЕ
СУБТИЛЬНЫЙ (ТОНКИЙ, НЕЖНЫЙ, ХРУПКИЙ)	ФОРМА, НАРУЖНЫЙ ВИД	ВЫШЕ
СФЕРА (ЗАМКНУТАЯ ПОВЕРХНОСТЬ)	ФОРМА, НАРУЖНЫЙ ВИД	ВЫШЕ
ТЕЛОСЛОЖЕНИЕ	ФОРМА, НАРУЖНЫЙ ВИД	ВЫШЕ
ТИБЕТСКОЕ НАГОРЬЕ	ФОРМА, НАРУЖНЫЙ ВИД	ВЫШЕ
ТИПОГРАФСКИЙ ШРИФТ	ФОРМА, НАРУЖНЫЙ ВИД	ВЫШЕ
ТРАПЕЦЕВИДНАЯ ФОРМА	ФОРМА, НАРУЖНЫЙ ВИД	ВЫШЕ
ТРЕУГОЛЬНАЯ ФОРМА	ФОРМА, НАРУЖНЫЙ ВИД	ВЫШЕ
ТРУБЧАТЫЙ (ФОРМА)	ФОРМА, НАРУЖНЫЙ ВИД	ВЫШЕ
ТЯНЬ-ШАНЬ	ФОРМА, НАРУЖНЫЙ ВИД	ВЫШЕ
УДЛИНЕННАЯ ФОРМА	ФОРМА, НАРУЖНЫЙ ВИД	ВЫШЕ
УШАСТЫЙ	ФОРМА, НАРУЖНЫЙ ВИД	ВЫШЕ
ФИГУРНАЯ ФОРМА	ФОРМА, НАРУЖНЫЙ ВИД	ВЫШЕ
ФИЗИЧЕСКИ КРЕПКИЙ	ФОРМА, НАРУЖНЫЙ ВИД	ВЫШЕ
ФОРМА КОЛЬЦА	ФОРМА, НАРУЖНЫЙ ВИД	ВЫШЕ
ФОРМА ПОЛУМЕСЯЦА	ФОРМА, НАРУЖНЫЙ ВИД	ВЫШЕ
ФОРМА, НАРУЖНЫЙ ВИД	ФОРМА, НАРУЖНЫЙ ВИД	ВЫШЕ
ХВОСТ (ПРИЧЕСКА)	ФОРМА, НАРУЖНЫЙ ВИД	ВЫШЕ
ХИБИНЫ	ФОРМА, НАРУЖНЫЙ ВИД	ВЫШЕ
ХИМИЧЕСКАЯ ЗАВИВКА	ФОРМА, НАРУЖНЫЙ ВИД	ВЫШЕ
ЦИЛИНДР (ГЕОМЕТРИЧЕСКОЕ ТЕЛО)	ФОРМА, НАРУЖНЫЙ ВИД	ВЫШЕ
ЦИЛИНДРИЧЕСКАЯ ФОРМА	ФОРМА, НАРУЖНЫЙ ВИД	ВЫШЕ
ЧЕРТЫ ЛИЦА	ФОРМА, НАРУЖНЫЙ ВИД	ВЫШЕ
ШАР (ГЕОМЕТРИЧЕСКОЕ ТЕЛО)	ФОРМА, НАРУЖНЫЙ ВИД	ВЫШЕ
ШАРООБРАЗНЫЙ	ФОРМА, НАРУЖНЫЙ ВИД	ВЫШЕ
ШЕЛКОВИСТЫЙ	ФОРМА, НАРУЖНЫЙ ВИД	ВЫШЕ
ШРИФТ	ФОРМА, НАРУЖНЫЙ ВИД	ВЫШЕ
ЭФИОПСКОЕ НАГОРЬЕ	ФОРМА, НАРУЖНЫЙ ВИД	ВЫШЕ
ЯЙЦЕВИДНАЯ ФОРМА	ФОРМА, НАРУЖНЫЙ ВИД	ВЫШЕ
ВСЕСТОРОННИЙ	ХАРАКТЕРИСТИКА ИНФОРМАЦИИ	ВЫШЕ
ДОСТОВЕРНОСТЬ ИНФОРМАЦИИ	ХАРАКТЕРИСТИКА ИНФОРМАЦИИ	ВЫШЕ
ИСЧЕРПЫВАЮЩИЙ	ХАРАКТЕРИСТИКА ИНФОРМАЦИИ	ВЫШЕ
КАЧЕСТВО ИНФОРМАЦИИ	ХАРАКТЕРИСТИКА ИНФОРМАЦИИ	ВЫШЕ
КОНФИДЕНЦИАЛЬНОСТЬ ИНФОРМАЦИИ	ХАРАКТЕРИСТИКА ИНФОРМАЦИИ	ВЫШЕ
НЕДОСТОВЕРНОСТЬ ИНФОРМАЦИИ	ХАРАКТЕРИСТИКА ИНФОРМАЦИИ	ВЫШЕ
ОБСТОЯТЕЛЬНЫЙ, ДОСКОНАЛЬНЫЙ	ХАРАКТЕРИСТИКА ИНФОРМАЦИИ	ВЫШЕ
ОБЩИЙ, НЕКОНКРЕТНЫЙ	ХАРАКТЕРИСТИКА ИНФОРМАЦИИ	ВЫШЕ
ПОДРОБНЫЙ, ДЕТАЛЬНЫЙ	ХАРАКТЕРИСТИКА ИНФОРМАЦИИ	ВЫШЕ
СЕКРЕТНОСТЬ ИНФОРМАЦИИ	ХАРАКТЕРИСТИКА ИНФОРМАЦИИ	ВЫШЕ
СХЕМАТИЧЕСКИЙ (УПРОЩЕННЫЙ)	ХАРАКТЕРИСТИКА ИНФОРМАЦИИ	ВЫШЕ
ХАРАКТЕРИСТИКА ИНФОРМАЦИИ	ХАРАКТЕРИСТИКА ИНФОРМАЦИИ	ВЫШЕИНДИВИДУАЛЬНОСТЬ	ИНДИВИДУАЛЬНОСТЬ	ВЫШЕАМПЛИТУДА	КОЛИЧЕСТВЕННЫЙ ПАРАМЕТР	ВЫШЕ
АРТЕРИАЛЬНОЕ ДАВЛЕНИЕ	КОЛИЧЕСТВЕННЫЙ ПАРАМЕТР	ВЫШЕ
АТМОСФЕРНОЕ ДАВЛЕНИЕ	КОЛИЧЕСТВЕННЫЙ ПАРАМЕТР	ВЫШЕ
БЕЛЕСЫЙ (ТУСКЛЫЙ И СВЕТЛЫЙ ДО БЕЛИЗНЫ)	КОЛИЧЕСТВЕННЫЙ ПАРАМЕТР	ВЫШЕ
БИРЖЕВОЙ КУРС	КОЛИЧЕСТВЕННЫЙ ПАРАМЕТР	ВЫШЕ
БОГАТЫЙ (ДОРОГОСТОЯЩИЙ)	КОЛИЧЕСТВЕННЫЙ ПАРАМЕТР	ВЫШЕ
БРУТТО	КОЛИЧЕСТВЕННЫЙ ПАРАМЕТР	ВЫШЕ
БЫСТРОДЕЙСТВИЕ (ПОКАЗАТЕЛЬ)	КОЛИЧЕСТВЕННЫЙ ПАРАМЕТР	ВЫШЕ
ВАЛЮТНЫЙ КУРС	КОЛИЧЕСТВЕННЫЙ ПАРАМЕТР	ВЫШЕ
ВЕСОВАЯ КАТЕГОРИЯ СПОРТСМЕНА	КОЛИЧЕСТВЕННЫЙ ПАРАМЕТР	ВЫШЕ
ВЛАЖНОСТЬ (НАЛИЧИЕ ВЛАГИ)	КОЛИЧЕСТВЕННЫЙ ПАРАМЕТР	ВЫШЕ
ВМЕСТИМОСТЬ (ПАРАМЕТР)	КОЛИЧЕСТВЕННЫЙ ПАРАМЕТР	ВЫШЕ
ВОДНОСТЬ ВОДОЕМА	КОЛИЧЕСТВЕННЫЙ ПАРАМЕТР	ВЫШЕ
ВОДОИЗМЕЩЕНИЕ	КОЛИЧЕСТВЕННЫЙ ПАРАМЕТР	ВЫШЕ
ВЫСОКОЕ НАПРЯЖЕНИЕ	КОЛИЧЕСТВЕННЫЙ ПАРАМЕТР	ВЫШЕ
ВЫСОТА (ЛИНЕЙНЫЙ РАЗМЕР)	КОЛИЧЕСТВЕННЫЙ ПАРАМЕТР	ВЫШЕ
ГАБАРИТ (ПРОТЯЖЕННОСТЬ)	КОЛИЧЕСТВЕННЫЙ ПАРАМЕТР	ВЫШЕ
ГЛУБИНА (РАССТОЯНИЕ)	КОЛИЧЕСТВЕННЫЙ ПАРАМЕТР	ВЫШЕ
ГРУЗОПОДЪЕМНОСТЬ	КОЛИЧЕСТВЕННЫЙ ПАРАМЕТР	ВЫШЕ
ДАВЛЕНИЕ (ФИЗИЧЕСКАЯ ВЕЛИЧИНА)	КОЛИЧЕСТВЕННЫЙ ПАРАМЕТР	ВЫШЕ
ДВУХМЕРНЫЙ	КОЛИЧЕСТВЕННЫЙ ПАРАМЕТР	ВЫШЕ
ДЕБИТ	КОЛИЧЕСТВЕННЫЙ ПАРАМЕТР	ВЫШЕ
ДЕШЕВЫЙ ПО ЦЕНЕ	КОЛИЧЕСТВЕННЫЙ ПАРАМЕТР	ВЫШЕ
ДИАМЕТР	КОЛИЧЕСТВЕННЫЙ ПАРАМЕТР	ВЫШЕ
ДЛИНА	КОЛИЧЕСТВЕННЫЙ ПАРАМЕТР	ВЫШЕ
ДОЗА ОБЛУЧЕНИЯ	КОЛИЧЕСТВЕННЫЙ ПАРАМЕТР	ВЫШЕ
ДОРОГОЙ ПО ЦЕНЕ	КОЛИЧЕСТВЕННЫЙ ПАРАМЕТР	ВЫШЕ
ДРАГОЦЕННЫЙ (ОЧЕНЬ ЦЕННЫЙ)	КОЛИЧЕСТВЕННЫЙ ПАРАМЕТР	ВЫШЕ
ЖИВОЙ ВЕС ЖИВОТНОГО	КОЛИЧЕСТВЕННЫЙ ПАРАМЕТР	ВЫШЕ
ЖИРНОСТЬ ЛИНИИ	КОЛИЧЕСТВЕННЫЙ ПАРАМЕТР	ВЫШЕ
ИЗБЫТОЧНАЯ МАССА ТЕЛА	КОЛИЧЕСТВЕННЫЙ ПАРАМЕТР	ВЫШЕ
ИМПУЛЬС (ФИЗИЧЕСКАЯ ВЕЛИЧИНА)	КОЛИЧЕСТВЕННЫЙ ПАРАМЕТР	ВЫШЕ
КАЛИБР СТВОЛА	КОЛИЧЕСТВЕННЫЙ ПАРАМЕТР	ВЫШЕ
КИСЛОТНОСТЬ (ПОКАЗАТЕЛЬ)	КОЛИЧЕСТВЕННЫЙ ПАРАМЕТР	ВЫШЕ
КОЛИЧЕСТВЕННЫЙ ПАРАМЕТР	КОЛИЧЕСТВЕННЫЙ ПАРАМЕТР	ВЫШЕ
КОНЦЕНТРАЦИЯ ВЕЩЕСТВА	КОЛИЧЕСТВЕННЫЙ ПАРАМЕТР	ВЫШЕ
КОЭФФИЦИЕНТ ПОЛЕЗНОГО ДЕЙСТВИЯ	КОЛИЧЕСТВЕННЫЙ ПАРАМЕТР	ВЫШЕ
КУБАТУРА (ОБЪЕМ)	КОЛИЧЕСТВЕННЫЙ ПАРАМЕТР	ВЫШЕ
КУРСОВАЯ СТОИМОСТЬ	КОЛИЧЕСТВЕННЫЙ ПАРАМЕТР	ВЫШЕ
ЛИТРАЖ	КОЛИЧЕСТВЕННЫЙ ПАРАМЕТР	ВЫШЕ
МАССА (ФИЗИЧЕСКАЯ ВЕЛИЧИНА)	КОЛИЧЕСТВЕННЫЙ ПАРАМЕТР	ВЫШЕ
МАССА ПРОДУКЦИИ	КОЛИЧЕСТВЕННЫЙ ПАРАМЕТР	ВЫШЕ
МАССА ТЕЛА ЧЕЛОВЕКА	КОЛИЧЕСТВЕННЫЙ ПАРАМЕТР	ВЫШЕ
МАТЕМАТИЧЕСКАЯ ВЕРОЯТНОСТЬ	КОЛИЧЕСТВЕННЫЙ ПАРАМЕТР	ВЫШЕ
МЕЛКОВОДНЫЙ	КОЛИЧЕСТВЕННЫЙ ПАРАМЕТР	ВЫШЕ
МЕРКА (ПРОТЯЖЕННОСТЬ)	КОЛИЧЕСТВЕННЫЙ ПАРАМЕТР	ВЫШЕ
МИНУСОВАЯ ТЕМПЕРАТУРА	КОЛИЧЕСТВЕННЫЙ ПАРАМЕТР	ВЫШЕ
МОМЕНТ (ФИЗИЧЕСКАЯ ВЕЛИЧИНА)	КОЛИЧЕСТВЕННЫЙ ПАРАМЕТР	ВЫШЕ
МОРЕХОДНЫЕ КАЧЕСТВА	КОЛИЧЕСТВЕННЫЙ ПАРАМЕТР	ВЫШЕ
МОРОЗНАЯ ПОГОДА	КОЛИЧЕСТВЕННЫЙ ПАРАМЕТР	ВЫШЕ
МОЩНОСТЬ (ВЕЛИЧИНА)	КОЛИЧЕСТВЕННЫЙ ПАРАМЕТР	ВЫШЕ
МОЩНОСТЬ ВЗРЫВА	КОЛИЧЕСТВЕННЫЙ ПАРАМЕТР	ВЫШЕ
НАПОЛНЯЕМОСТЬ	КОЛИЧЕСТВЕННЫЙ ПАРАМЕТР	ВЫШЕ
НАПОР (ДАВЛЕНИЕ)	КОЛИЧЕСТВЕННЫЙ ПАРАМЕТР	ВЫШЕ
НАРАБОТКА УСТРОЙСТВА	КОЛИЧЕСТВЕННЫЙ ПАРАМЕТР	ВЫШЕ
НЕТТО	КОЛИЧЕСТВЕННЫЙ ПАРАМЕТР	ВЫШЕ
НЕФТЕОТДАЧА	КОЛИЧЕСТВЕННЫЙ ПАРАМЕТР	ВЫШЕ
НИЗКОЕ НАПРЯЖЕНИЕ	КОЛИЧЕСТВЕННЫЙ ПАРАМЕТР	ВЫШЕ
НИЗКОРОСЛЫЙ, НИЗКОГО РОСТА	КОЛИЧЕСТВЕННЫЙ ПАРАМЕТР	ВЫШЕ
НОМИНАЛЬНАЯ СТОИМОСТЬ	КОЛИЧЕСТВЕННЫЙ ПАРАМЕТР	ВЫШЕ
ОБТЕКАЕМОСТЬ ТРАНСПОРТНОГО СРЕДСТВА	КОЛИЧЕСТВЕННЫЙ ПАРАМЕТР	ВЫШЕ
ОБХВАТ (РАЗМЕР)	КОЛИЧЕСТВЕННЫЙ ПАРАМЕТР	ВЫШЕ
ОБЪЕМ (ВЕЛИЧИНА В ДЛИНУ, ШИРИНУ И ВЫСОТУ)	КОЛИЧЕСТВЕННЫЙ ПАРАМЕТР	ВЫШЕ
ОКТАНОВОЕ ЧИСЛО	КОЛИЧЕСТВЕННЫЙ ПАРАМЕТР	ВЫШЕ
ОПТОВАЯ ЦЕНА	КОЛИЧЕСТВЕННЫЙ ПАРАМЕТР	ВЫШЕ
ОСАДКА СУДНА	КОЛИЧЕСТВЕННЫЙ ПАРАМЕТР	ВЫШЕ
ОСЛЕПИТЕЛЬНО ЯРКИЙ	КОЛИЧЕСТВЕННЫЙ ПАРАМЕТР	ВЫШЕ
ПЕРИМЕТР ГЕОМЕТРИЧЕСКОЙ ФИГУРЫ	КОЛИЧЕСТВЕННЫЙ ПАРАМЕТР	ВЫШЕ
ПЛОТНОСТЬ ВЕЩЕСТВА	КОЛИЧЕСТВЕННЫЙ ПАРАМЕТР	ВЫШЕ
ПЛОЩАДЬ (ПАРАМЕТР)	КОЛИЧЕСТВЕННЫЙ ПАРАМЕТР	ВЫШЕ
ПЛОЩАДЬ ЖИЛЬЯ	КОЛИЧЕСТВЕННЫЙ ПАРАМЕТР	ВЫШЕ
ПЛОЩАДЬ ПОМЕЩЕНИЯ	КОЛИЧЕСТВЕННЫЙ ПАРАМЕТР	ВЫШЕ
ПЛЮСОВАЯ ТЕМПЕРАТУРА	КОЛИЧЕСТВЕННЫЙ ПАРАМЕТР	ВЫШЕ
ПОКУПНАЯ ЦЕНА	КОЛИЧЕСТВЕННЫЙ ПАРАМЕТР	ВЫШЕ
ПОЛМЕТРА	КОЛИЧЕСТВЕННЫЙ ПАРАМЕТР	ВЫШЕ
ПОЛНОВОДНЫЙ, ГЛУБОКОВОДНЫЙ	КОЛИЧЕСТВЕННЫЙ ПАРАМЕТР	ВЫШЕ
ПОЛУСРЕДНИЙ ВЕС	КОЛИЧЕСТВЕННЫЙ ПАРАМЕТР	ВЫШЕ
ПОЛУТЯЖЕЛЫЙ ВЕС	КОЛИЧЕСТВЕННЫЙ ПАРАМЕТР	ВЫШЕ
ПОПЕРЕЧНИК	КОЛИЧЕСТВЕННЫЙ ПАРАМЕТР	ВЫШЕ
ПОСЕЩАЕМОСТЬ	КОЛИЧЕСТВЕННЫЙ ПАРАМЕТР	ВЫШЕ
ПОСЛУШНЫЙ В УПРАВЛЕНИИ	КОЛИЧЕСТВЕННЫЙ ПАРАМЕТР	ВЫШЕ
ПОТЕНЦИАЛ (ФИЗИЧЕСКАЯ ВЕЛИЧИНА)	КОЛИЧЕСТВЕННЫЙ ПАРАМЕТР	ВЫШЕ
ПОТРЕБИТЕЛЬСКАЯ (РОЗНИЧНАЯ) ЦЕНА	КОЛИЧЕСТВЕННЫЙ ПАРАМЕТР	ВЫШЕ
ПРЕМИУМ КЛАСС	КОЛИЧЕСТВЕННЫЙ ПАРАМЕТР	ВЫШЕ
ПРОБЕГ ТРАНСПОРТНОГО СРЕДСТВА	КОЛИЧЕСТВЕННЫЙ ПАРАМЕТР	ВЫШЕ
ПРОСВЕТ ПРОЕМА	КОЛИЧЕСТВЕННЫЙ ПАРАМЕТР	ВЫШЕ
ПРОТЯЖЕННОСТЬ	КОЛИЧЕСТВЕННЫЙ ПАРАМЕТР	ВЫШЕ
РАДИОЧАСТОТА	КОЛИЧЕСТВЕННЫЙ ПАРАМЕТР	ВЫШЕ
РАДИУС КРУГА, ШАРА	КОЛИЧЕСТВЕННЫЙ ПАРАМЕТР	ВЫШЕ
РАЗМАХ МЕЖДУ КРАЙНИМИ ТОЧКАМИ	КОЛИЧЕСТВЕННЫЙ ПАРАМЕТР	ВЫШЕ
РАЗМЕРНОСТЬ, ЧИСЛО ИЗМЕРЕНИЙ	КОЛИЧЕСТВЕННЫЙ ПАРАМЕТР	ВЫШЕ
РАЗРЕШЕНИЕ ИЗОБРАЖЕНИЯ	КОЛИЧЕСТВЕННЫЙ ПАРАМЕТР	ВЫШЕ
РАСЦЕНКИ НА УСЛУГИ	КОЛИЧЕСТВЕННЫЙ ПАРАМЕТР	ВЫШЕ
РОСКОШНЫЙ, ПЫШНЫЙ	КОЛИЧЕСТВЕННЫЙ ПАРАМЕТР	ВЫШЕ
РОСЛЫЙ, ВЫСОКОГО РОСТА	КОЛИЧЕСТВЕННЫЙ ПАРАМЕТР	ВЫШЕ
РОСТ ЧЕЛОВЕКА, ЖИВОТНОГО	КОЛИЧЕСТВЕННЫЙ ПАРАМЕТР	ВЫШЕ
РЫНОЧНАЯ ЦЕНА	КОЛИЧЕСТВЕННЫЙ ПАРАМЕТР	ВЫШЕ
СВЕРХЗВУКОВАЯ СКОРОСТЬ	КОЛИЧЕСТВЕННЫЙ ПАРАМЕТР	ВЫШЕ
СВЕТЛЫЙ, ХОРОШО ОСВЕЩЕННЫЙ	КОЛИЧЕСТВЕННЫЙ ПАРАМЕТР	ВЫШЕ
СЕЙСМИЧНОСТЬ	КОЛИЧЕСТВЕННЫЙ ПАРАМЕТР	ВЫШЕ
СИЛА (ФИЗИЧЕСКАЯ ВЕЛИЧИНА)	КОЛИЧЕСТВЕННЫЙ ПАРАМЕТР	ВЫШЕ
СИЛА ВЕСА	КОЛИЧЕСТВЕННЫЙ ПАРАМЕТР	ВЫШЕ
СИЛА ПРИТЯЖЕНИЯ	КОЛИЧЕСТВЕННЫЙ ПАРАМЕТР	ВЫШЕ
СИЛА ТОКА	КОЛИЧЕСТВЕННЫЙ ПАРАМЕТР	ВЫШЕ
СИЛА ТЯГИ	КОЛИЧЕСТВЕННЫЙ ПАРАМЕТР	ВЫШЕ
СИЛА ТЯЖЕСТИ	КОЛИЧЕСТВЕННЫЙ ПАРАМЕТР	ВЫШЕ
СКОРОСТРЕЛЬНОСТЬ	КОЛИЧЕСТВЕННЫЙ ПАРАМЕТР	ВЫШЕ
СКОРОСТЬ ВРАЩЕНИЯ	КОЛИЧЕСТВЕННЫЙ ПАРАМЕТР	ВЫШЕ
СКОРОСТЬ ДВИЖЕНИЯ	КОЛИЧЕСТВЕННЫЙ ПАРАМЕТР	ВЫШЕ
СЛИШКОМ ДЕШЕВЫЙ	КОЛИЧЕСТВЕННЫЙ ПАРАМЕТР	ВЫШЕ
СНИЖЕННАЯ ЦЕНА	КОЛИЧЕСТВЕННЫЙ ПАРАМЕТР	ВЫШЕ
СТОИМОСТЬ КРЕДИТА	КОЛИЧЕСТВЕННЫЙ ПАРАМЕТР	ВЫШЕ
СУПЕРТЯЖЕЛЫЙ ВЕС	КОЛИЧЕСТВЕННЫЙ ПАРАМЕТР	ВЫШЕ
ТАКТИКО-ТЕХНИЧЕСКИЕ ХАРАКТЕРИСТИКИ	КОЛИЧЕСТВЕННЫЙ ПАРАМЕТР	ВЫШЕ
ТАКТОВАЯ ЧАСТОТА	КОЛИЧЕСТВЕННЫЙ ПАРАМЕТР	ВЫШЕ
ТЕМПЕРАТУРА	КОЛИЧЕСТВЕННЫЙ ПАРАМЕТР	ВЫШЕ
ТЕМПЕРАТУРА ВОЗДУХА	КОЛИЧЕСТВЕННЫЙ ПАРАМЕТР	ВЫШЕ
ТЕМПЕРАТУРА ТЕЛА	КОЛИЧЕСТВЕННЫЙ ПАРАМЕТР	ВЫШЕ
ТЕПЛОЕМКОСТЬ	КОЛИЧЕСТВЕННЫЙ ПАРАМЕТР	ВЫШЕ
ТЕРМОДИНАМИЧЕСКАЯ ЭНТРОПИЯ	КОЛИЧЕСТВЕННЫЙ ПАРАМЕТР	ВЫШЕ
ТЕХНИКО-ЭКОНОМИЧЕСКИЙ ПОКАЗАТЕЛЬ	КОЛИЧЕСТВЕННЫЙ ПАРАМЕТР	ВЫШЕ
ТЕХНИКО-ЭКСПЛУАТАЦИОННЫЙ ПОКАЗАТЕЛЬ	КОЛИЧЕСТВЕННЫЙ ПАРАМЕТР	ВЫШЕ
ТЕХНИЧЕСКИЙ ПОКАЗАТЕЛЬ	КОЛИЧЕСТВЕННЫЙ ПАРАМЕТР	ВЫШЕ
ТОЛЩИНА (ПРОТЯЖЕННОСТЬ)	КОЛИЧЕСТВЕННЫЙ ПАРАМЕТР	ВЫШЕ
ТРАФИК СЕТИ	КОЛИЧЕСТВЕННЫЙ ПАРАМЕТР	ВЫШЕ
ТРЕХМЕРНЫЙ	КОЛИЧЕСТВЕННЫЙ ПАРАМЕТР	ВЫШЕ
ТУСКЛЫЙ, НЕЯРКИЙ	КОЛИЧЕСТВЕННЫЙ ПАРАМЕТР	ВЫШЕ
УДЕЛЬНЫЙ ПАРАМЕТР	КОЛИЧЕСТВЕННЫЙ ПАРАМЕТР	ВЫШЕ
УСКОРЕНИЕ (ФИЗИЧЕСКАЯ ВЕЛИЧИНА)	КОЛИЧЕСТВЕННЫЙ ПАРАМЕТР	ВЫШЕ
ФИЗИЧЕСКАЯ ВЕЛИЧИНА	КОЛИЧЕСТВЕННЫЙ ПАРАМЕТР	ВЫШЕ
ФОРМАТ БУМАГИ	КОЛИЧЕСТВЕННЫЙ ПАРАМЕТР	ВЫШЕ
ХАРАКТЕРИСТИКА ТРАНСПОРТНОГО СРЕДСТВА	КОЛИЧЕСТВЕННЫЙ ПАРАМЕТР	ВЫШЕ
ХОДОВЫЕ КАЧЕСТВА	КОЛИЧЕСТВЕННЫЙ ПАРАМЕТР	ВЫШЕ
ХОЛОД (НИЗКАЯ ТЕМПЕРАТУРА ВОЗДУХА)	КОЛИЧЕСТВЕННЫЙ ПАРАМЕТР	ВЫШЕ
ХОЛОДНАЯ ПОГОДА	КОЛИЧЕСТВЕННЫЙ ПАРАМЕТР	ВЫШЕ
ЦЕНА ТОВАРА, УСЛУГИ	КОЛИЧЕСТВЕННЫЙ ПАРАМЕТР	ВЫШЕ
ЦЕНТРОБЕЖНАЯ СИЛА	КОЛИЧЕСТВЕННЫЙ ПАРАМЕТР	ВЫШЕ
ЧАСТОТА В ЕДИНИЦУ ВРЕМЕНИ	КОЛИЧЕСТВЕННЫЙ ПАРАМЕТР	ВЫШЕ
ЧАСТОТНОСТЬ (ЧАСТОТА ПОЯВЛЕНИЯ)	КОЛИЧЕСТВЕННЫЙ ПАРАМЕТР	ВЫШЕ
ШИРИНА	КОЛИЧЕСТВЕННЫЙ ПАРАМЕТР	ВЫШЕ
ЭКОНОМИЧНОСТЬ	КОЛИЧЕСТВЕННЫЙ ПАРАМЕТР	ВЫШЕ
ЭЛЕКТРИЧЕСКАЯ ЕМКОСТЬ	КОЛИЧЕСТВЕННЫЙ ПАРАМЕТР	ВЫШЕ
ЭЛЕКТРИЧЕСКОЕ НАПРЯЖЕНИЕ	КОЛИЧЕСТВЕННЫЙ ПАРАМЕТР	ВЫШЕ
ЭНЕРГОЕМКОСТЬ	КОЛИЧЕСТВЕННЫЙ ПАРАМЕТР	ВЫШЕ
ЯРКИЙ ПО СВЕТУ	КОЛИЧЕСТВЕННЫЙ ПАРАМЕТР	ВЫШЕ
ЯРКОСТЬ СВЕТА	КОЛИЧЕСТВЕННЫЙ ПАРАМЕТР	ВЫШЕ
АВАРИЙНОСТЬ (ПОКАЗАТЕЛЬ)	ПОКАЗАТЕЛЬ (ДАННЫЕ)	ВЫШЕ
АРТЕРИАЛЬНОЕ ДАВЛЕНИЕ	ПОКАЗАТЕЛЬ (ДАННЫЕ)	ВЫШЕ
БАНКРОТСТВО, НЕСОСТОЯТЕЛЬНОСТЬ	ПОКАЗАТЕЛЬ (ДАННЫЕ)	ВЫШЕ
БЕЗРАБОТИЦА	ПОКАЗАТЕЛЬ (ДАННЫЕ)	ВЫШЕ
БОЛЬШОЙ УРОЖАЙ	ПОКАЗАТЕЛЬ (ДАННЫЕ)	ВЫШЕ
БУХГАЛТЕРСКИЙ БАЛАНС	ПОКАЗАТЕЛЬ (ДАННЫЕ)	ВЫШЕ
ВАЛОВОЙ ПОКАЗАТЕЛЬ	ПОКАЗАТЕЛЬ (ДАННЫЕ)	ВЫШЕ
ВОЛАТИЛЬНОСТЬ ЦЕН	ПОКАЗАТЕЛЬ (ДАННЫЕ)	ВЫШЕ
ВЫИГРЫШ (ПРИОБРЕТЕНИЕ)	ПОКАЗАТЕЛЬ (ДАННЫЕ)	ВЫШЕ
ВЫСОКАЯ КАЛОРИЙНОСТЬ	ПОКАЗАТЕЛЬ (ДАННЫЕ)	ВЫШЕ
ВЫСШЕЕ ОБРАЗОВАНИЕ	ПОКАЗАТЕЛЬ (ДАННЫЕ)	ВЫШЕ
ВЫСШЕЕ ТЕХНИЧЕСКОЕ ОБРАЗОВАНИЕ	ПОКАЗАТЕЛЬ (ДАННЫЕ)	ВЫШЕ
ГОНОРАР	ПОКАЗАТЕЛЬ (ДАННЫЕ)	ВЫШЕ
ГРАНТ	ПОКАЗАТЕЛЬ (ДАННЫЕ)	ВЫШЕ
ГРУЗООБОРОТ	ПОКАЗАТЕЛЬ (ДАННЫЕ)	ВЫШЕ
ГУСТОНАСЕЛЕННОСТЬ	ПОКАЗАТЕЛЬ (ДАННЫЕ)	ВЫШЕ
ДВИЖЕНИЕ РАБОЧЕЙ СИЛЫ	ПОКАЗАТЕЛЬ (ДАННЫЕ)	ВЫШЕ
ДЕМОГРАФИЧЕСКИЙ ПОКАЗАТЕЛЬ	ПОКАЗАТЕЛЬ (ДАННЫЕ)	ВЫШЕ
ДЕНЕЖНАЯ ВЫРУЧКА	ПОКАЗАТЕЛЬ (ДАННЫЕ)	ВЫШЕ
ДЕНЕЖНЫЙ ДОХОД	ПОКАЗАТЕЛЬ (ДАННЫЕ)	ВЫШЕ
ДИВИДЕНД	ПОКАЗАТЕЛЬ (ДАННЫЕ)	ВЫШЕ
ДОБАВЛЕННАЯ СТОИМОСТЬ	ПОКАЗАТЕЛЬ (ДАННЫЕ)	ВЫШЕ
ДОХОД	ПОКАЗАТЕЛЬ (ДАННЫЕ)	ВЫШЕ
ДОХОДНАЯ ЧАСТЬ БЮДЖЕТА	ПОКАЗАТЕЛЬ (ДАННЫЕ)	ВЫШЕ
ДОХОДЫ НАСЕЛЕНИЯ	ПОКАЗАТЕЛЬ (ДАННЫЕ)	ВЫШЕ
ЕСТЕСТВЕННОЕ ДВИЖЕНИЕ НАСЕЛЕНИЯ	ПОКАЗАТЕЛЬ (ДАННЫЕ)	ВЫШЕ
ЕСТЕСТВЕННЫЙ ПРИРОСТ НАСЕЛЕНИЯ	ПОКАЗАТЕЛЬ (ДАННЫЕ)	ВЫШЕ
ЖИРНОСТЬ (ПИЩЕВАЯ ЦЕННОСТЬ)	ПОКАЗАТЕЛЬ (ДАННЫЕ)	ВЫШЕ
ЖИРНЫЙ, БОГАТЫЙ ЖИРАМИ	ПОКАЗАТЕЛЬ (ДАННЫЕ)	ВЫШЕ
ЗАБОЛЕВАЕМОСТЬ	ПОКАЗАТЕЛЬ (ДАННЫЕ)	ВЫШЕ
ЗАНЯТОСТЬ НАСЕЛЕНИЯ	ПОКАЗАТЕЛЬ (ДАННЫЕ)	ВЫШЕ
ЗАРАБОТНАЯ ПЛАТА	ПОКАЗАТЕЛЬ (ДАННЫЕ)	ВЫШЕ
ИНВЕСТИЦИИ В ОСНОВНОЙ КАПИТАЛ	ПОКАЗАТЕЛЬ (ДАННЫЕ)	ВЫШЕ
ИНВЕСТИЦИОННЫЙ ДОХОД	ПОКАЗАТЕЛЬ (ДАННЫЕ)	ВЫШЕ
ИНДЕКС (ПОКАЗАТЕЛЬ)	ПОКАЗАТЕЛЬ (ДАННЫЕ)	ВЫШЕ
ИНТЕЛЛЕКТУАЛЬНАЯ МИГРАЦИЯ	ПОКАЗАТЕЛЬ (ДАННЫЕ)	ВЫШЕ
КАЛОРИЙНОСТЬ ЕДЫ	ПОКАЗАТЕЛЬ (ДАННЫЕ)	ВЫШЕ
КАССОВЫЕ СБОРЫ	ПОКАЗАТЕЛЬ (ДАННЫЕ)	ВЫШЕ
КОНКУРЕНТОСПОСОБНОСТЬ	ПОКАЗАТЕЛЬ (ДАННЫЕ)	ВЫШЕ
КОРЗИНА (ИНДЕКС)	ПОКАЗАТЕЛЬ (ДАННЫЕ)	ВЫШЕ
ЛИКВИДНОСТЬ (ФИНАНСОВЫЙ ПОКАЗАТЕЛЬ)	ПОКАЗАТЕЛЬ (ДАННЫЕ)	ВЫШЕ
ЛИКВИДНОСТЬ БАНКА	ПОКАЗАТЕЛЬ (ДАННЫЕ)	ВЫШЕ
МЕДИЦИНСКАЯ СТАТИСТИКА	ПОКАЗАТЕЛЬ (ДАННЫЕ)	ВЫШЕ
МИНИМАЛЬНАЯ ЗАРАБОТНАЯ ПЛАТА	ПОКАЗАТЕЛЬ (ДАННЫЕ)	ВЫШЕ
МНОГОНАЦИОНАЛЬНЫЙ СОСТАВ НАСЕЛЕНИЯ	ПОКАЗАТЕЛЬ (ДАННЫЕ)	ВЫШЕ
МОНЕТИЗАЦИЯ ЭКОНОМИКИ	ПОКАЗАТЕЛЬ (ДАННЫЕ)	ВЫШЕ
НАДОЙ МОЛОКА	ПОКАЗАТЕЛЬ (ДАННЫЕ)	ВЫШЕ
НАЖИВА, НАВАР	ПОКАЗАТЕЛЬ (ДАННЫЕ)	ВЫШЕ
НАЧАЛЬНОЕ ОБРАЗОВАНИЕ	ПОКАЗАТЕЛЬ (ДАННЫЕ)	ВЫШЕ
НЕЖИРНЫЙ, МАЛОЖИРНЫЙ	ПОКАЗАТЕЛЬ (ДАННЫЕ)	ВЫШЕ
НЕПЛАТЕЖЕСПОСОБНОСТЬ	ПОКАЗАТЕЛЬ (ДАННЫЕ)	ВЫШЕ
НЕРВНО-МЫШЕЧНЫЙ ТОНУС	ПОКАЗАТЕЛЬ (ДАННЫЕ)	ВЫШЕ
НЕРЕНТАБЕЛЬНОСТЬ	ПОКАЗАТЕЛЬ (ДАННЫЕ)	ВЫШЕ
НЕТРУДОВЫЕ ДОХОДЫ	ПОКАЗАТЕЛЬ (ДАННЫЕ)	ВЫШЕ
НЕУРОЖАЙ	ПОКАЗАТЕЛЬ (ДАННЫЕ)	ВЫШЕ
НИЗКОКАЛОРИЙНОСТЬ	ПОКАЗАТЕЛЬ (ДАННЫЕ)	ВЫШЕ
НОРМАТИВ	ПОКАЗАТЕЛЬ (ДАННЫЕ)	ВЫШЕ
ОБЕЗЖИРЕННОСТЬ	ПОКАЗАТЕЛЬ (ДАННЫЕ)	ВЫШЕ
ОКУПАЕМОСТЬ КАПИТАЛЬНЫХ ВЛОЖЕНИЙ	ПОКАЗАТЕЛЬ (ДАННЫЕ)	ВЫШЕ
ОСНОВНОЙ ЭКОНОМИЧЕСКИЙ ПОКАЗАТЕЛЬ	ПОКАЗАТЕЛЬ (ДАННЫЕ)	ВЫШЕ
ПАССАЖИРООБОРОТ	ПОКАЗАТЕЛЬ (ДАННЫЕ)	ВЫШЕ
ПИЩЕВАЯ ЦЕННОСТЬ	ПОКАЗАТЕЛЬ (ДАННЫЕ)	ВЫШЕ
ПЛАТЕЖЕСПОСОБНОСТЬ	ПОКАЗАТЕЛЬ (ДАННЫЕ)	ВЫШЕ
ПЛОДОРОДИЕ ЗЕМЕЛЬ	ПОКАЗАТЕЛЬ (ДАННЫЕ)	ВЫШЕ
ПЛОТНОСТЬ НАСЕЛЕНИЯ	ПОКАЗАТЕЛЬ (ДАННЫЕ)	ВЫШЕ
ПОВРЕМЕННАЯ ОПЛАТА ТРУДА	ПОКАЗАТЕЛЬ (ДАННЫЕ)	ВЫШЕ
ПОГОЛОВЬЕ СКОТА	ПОКАЗАТЕЛЬ (ДАННЫЕ)	ВЫШЕ
ПОКАЗАТЕЛЬ (ДАННЫЕ)	ПОКАЗАТЕЛЬ (ДАННЫЕ)	ВЫШЕ
ПОКАЗАТЕЛЬ ДЕЯТЕЛЬНОСТИ БАНКА	ПОКАЗАТЕЛЬ (ДАННЫЕ)	ВЫШЕ
ПОКАЗАТЕЛЬ ДОХОДНОСТИ	ПОКАЗАТЕЛЬ (ДАННЫЕ)	ВЫШЕ
ПОКАЗАТЕЛЬ ФЕРТИЛЬНОСТИ	ПОКАЗАТЕЛЬ (ДАННЫЕ)	ВЫШЕ
ПОЛСТАВКИ	ПОКАЗАТЕЛЬ (ДАННЫЕ)	ВЫШЕ
ПРИБАВОЧНАЯ СТОИМОСТЬ	ПОКАЗАТЕЛЬ (ДАННЫЕ)	ВЫШЕ
ПРИБЫЛЬ	ПОКАЗАТЕЛЬ (ДАННЫЕ)	ВЫШЕ
ПРОДОВОЛЬСТВЕННАЯ КОРЗИНА	ПОКАЗАТЕЛЬ (ДАННЫЕ)	ВЫШЕ
ПРОДУКТИВНОСТЬ СЕЛЬСКОХОЗЯЙСТВЕННЫХ УГОДИЙ	ПОКАЗАТЕЛЬ (ДАННЫЕ)	ВЫШЕ
ПРОЖИТОЧНЫЙ МИНИМУМ	ПОКАЗАТЕЛЬ (ДАННЫЕ)	ВЫШЕ
ПРОИЗВОДИТЕЛЬНОСТЬ (ПОКАЗАТЕЛЬ)	ПОКАЗАТЕЛЬ (ДАННЫЕ)	ВЫШЕ
ПРОИЗВОДИТЕЛЬНОСТЬ ТРУДА	ПОКАЗАТЕЛЬ (ДАННЫЕ)	ВЫШЕ
ПРОИЗВОДСТВЕННАЯ МОЩНОСТЬ	ПОКАЗАТЕЛЬ (ДАННЫЕ)	ВЫШЕ
ПРОМЫСЕЛ (САМОЗАНЯТОСТЬ)	ПОКАЗАТЕЛЬ (ДАННЫЕ)	ВЫШЕ
ПРОЦЕНТНОЕ ОТНОШЕНИЕ	ПОКАЗАТЕЛЬ (ДАННЫЕ)	ВЫШЕ
РАБОТА ЗА РУБЕЖОМ	ПОКАЗАТЕЛЬ (ДАННЫЕ)	ВЫШЕ
РАСКРЫВАЕМОСТЬ ПРЕСТУПЛЕНИЙ	ПОКАЗАТЕЛЬ (ДАННЫЕ)	ВЫШЕ
РЕЙТИНГ	ПОКАЗАТЕЛЬ (ДАННЫЕ)	ВЫШЕ
РЕЙТИНГ ПОПУЛЯРНОСТИ	ПОКАЗАТЕЛЬ (ДАННЫЕ)	ВЫШЕ
РЕКОРД	ПОКАЗАТЕЛЬ (ДАННЫЕ)	ВЫШЕ
РЕНТА	ПОКАЗАТЕЛЬ (ДАННЫЕ)	ВЫШЕ
РЕНТАБЕЛЬНОСТЬ	ПОКАЗАТЕЛЬ (ДАННЫЕ)	ВЫШЕ
РОЖДАЕМОСТЬ	ПОКАЗАТЕЛЬ (ДАННЫЕ)	ВЫШЕ
РЫНОЧНАЯ КАПИТАЛИЗАЦИЯ	ПОКАЗАТЕЛЬ (ДАННЫЕ)	ВЫШЕ
САМОЗАНЯТОСТЬ	ПОКАЗАТЕЛЬ (ДАННЫЕ)	ВЫШЕ
СВЕРХПРИБЫЛЬ	ПОКАЗАТЕЛЬ (ДАННЫЕ)	ВЫШЕ
СДЕЛЬНАЯ ОПЛАТА	ПОКАЗАТЕЛЬ (ДАННЫЕ)	ВЫШЕ
СЕБЕСТОИМОСТЬ	ПОКАЗАТЕЛЬ (ДАННЫЕ)	ВЫШЕ
СЕЛЬСКОХОЗЯЙСТВЕННАЯ ПРОДУКТИВНОСТЬ	ПОКАЗАТЕЛЬ (ДАННЫЕ)	ВЫШЕ
СЕЛЬСКОХОЗЯЙСТВЕННЫЙ ПОКАЗАТЕЛЬ	ПОКАЗАТЕЛЬ (ДАННЫЕ)	ВЫШЕ
СМЕРТНОСТЬ НАСЕЛЕНИЯ	ПОКАЗАТЕЛЬ (ДАННЫЕ)	ВЫШЕ
СОБИРАЕМОСТЬ ПЛАТЕЖЕЙ	ПОКАЗАТЕЛЬ (ДАННЫЕ)	ВЫШЕ
СОСТАВ НАСЕЛЕНИЯ	ПОКАЗАТЕЛЬ (ДАННЫЕ)	ВЫШЕ
СОЦИАЛЬНО-ЭКОНОМИЧЕСКИЙ ПОКАЗАТЕЛЬ	ПОКАЗАТЕЛЬ (ДАННЫЕ)	ВЫШЕ
СОЦИАЛЬНЫЙ ПОКАЗАТЕЛЬ	ПОКАЗАТЕЛЬ (ДАННЫЕ)	ВЫШЕ
СПОРТИВНЫЙ РЕКОРД	ПОКАЗАТЕЛЬ (ДАННЫЕ)	ВЫШЕ
СРЕДНЕЕ ОБЩЕЕ ОБРАЗОВАНИЕ	ПОКАЗАТЕЛЬ (ДАННЫЕ)	ВЫШЕ
СРЕДНЕЕ СПЕЦИАЛЬНОЕ ОБРАЗОВАНИЕ	ПОКАЗАТЕЛЬ (ДАННЫЕ)	ВЫШЕ
СРЕДНЕЕ ТЕХНИЧЕСКОЕ ОБРАЗОВАНИЕ	ПОКАЗАТЕЛЬ (ДАННЫЕ)	ВЫШЕ
СТАТИСТИЧЕСКИЙ ПОКАЗАТЕЛЬ	ПОКАЗАТЕЛЬ (ДАННЫЕ)	ВЫШЕ
СТОИМОСТЬ	ПОКАЗАТЕЛЬ (ДАННЫЕ)	ВЫШЕ
ТЕКУЧЕСТЬ КАДРОВ	ПОКАЗАТЕЛЬ (ДАННЫЕ)	ВЫШЕ
ТЕХНИЧЕСКИЕ НОРМЫ	ПОКАЗАТЕЛЬ (ДАННЫЕ)	ВЫШЕ
ТЕХНИЧЕСКИЕ УСЛОВИЯ (НОРМАТИВ)	ПОКАЗАТЕЛЬ (ДАННЫЕ)	ВЫШЕ
ТОВАРООБОРОТ	ПОКАЗАТЕЛЬ (ДАННЫЕ)	ВЫШЕ
ТРУДОВАЯ МИГРАЦИЯ	ПОКАЗАТЕЛЬ (ДАННЫЕ)	ВЫШЕ
ТРУДОВОЙ ДОХОД	ПОКАЗАТЕЛЬ (ДАННЫЕ)	ВЫШЕ
УБЫЛЬ НАСЕЛЕНИЯ	ПОКАЗАТЕЛЬ (ДАННЫЕ)	ВЫШЕ
УБЫТОК	ПОКАЗАТЕЛЬ (ДАННЫЕ)	ВЫШЕ
УРОВЕНЬ ОБРАЗОВАНИЯ	ПОКАЗАТЕЛЬ (ДАННЫЕ)	ВЫШЕ
УРОЖАЙ	ПОКАЗАТЕЛЬ (ДАННЫЕ)	ВЫШЕ
УРОЖАЙНОСТЬ	ПОКАЗАТЕЛЬ (ДАННЫЕ)	ВЫШЕ
ФИНАНСОВЫЕ РЕЗУЛЬТАТЫ	ПОКАЗАТЕЛЬ (ДАННЫЕ)	ВЫШЕ
ФИНАНСОВЫЙ ПОКАЗАТЕЛЬ	ПОКАЗАТЕЛЬ (ДАННЫЕ)	ВЫШЕ
ХИТ-ПАРАД	ПОКАЗАТЕЛЬ (ДАННЫЕ)	ВЫШЕ
ЧАСТИЧНАЯ ЗАНЯТОСТЬ	ПОКАЗАТЕЛЬ (ДАННЫЕ)	ВЫШЕ
ЧИСТЫЙ ДОХОД	ПОКАЗАТЕЛЬ (ДАННЫЕ)	ВЫШЕ
ЭКОНОМИЧЕСКИЙ ПОКАЗАТЕЛЬ	ПОКАЗАТЕЛЬ (ДАННЫЕ)	ВЫШЕ
ЭЛАСТИЧНОСТЬ СПРОСА И ПРЕДЛОЖЕНИЯ	ПОКАЗАТЕЛЬ (ДАННЫЕ)	ВЫШЕ
ЭПИДЕМИЧЕСКИЙ ПОРОГ	ПОКАЗАТЕЛЬ (ДАННЫЕ)	ВЫШЕПРИМЕТА (ОТЛИЧИТЕЛЬНЫЙ ПРИЗНАК)	ПРИМЕТА (ОТЛИЧИТЕЛЬНЫЙ ПРИЗНАК)	ВЫШЕХАРАКТЕР (ОТЛИЧИТЕЛЬНАЯ ОСОБЕННОСТЬ)	ХАРАКТЕР (ОТЛИЧИТЕЛЬНАЯ ОСОБЕННОСТЬ)	ВЫШЕ
ХАРАКТЕР ЧЕЛОВЕКА	ХАРАКТЕР (ОТЛИЧИТЕЛЬНАЯ ОСОБЕННОСТЬ)	ВЫШЕ
ЧЕРТА	ЧЕРТА	ВЫШЕ
АККУРАТНЫЙ (ЧЕРТА ХАРАКТЕРА)	ЧЕРТА ХАРАКТЕРА	ВЫШЕ
АКТИВНЫЙ, ДЕЯТЕЛЬНЫЙ	ЧЕРТА ХАРАКТЕРА	ВЫШЕ
АЛЬТРУИЗМ	ЧЕРТА ХАРАКТЕРА	ВЫШЕ
АПЛОМБ (ВЫСОКОМЕРИЕ)	ЧЕРТА ХАРАКТЕРА	ВЫШЕ
АТОНИЯ МЫШЦ	ЧЕРТА ХАРАКТЕРА	ВЫШЕ
БДИТЕЛЬНЫЙ	ЧЕРТА ХАРАКТЕРА	ВЫШЕ
БЕЗДЕЯТЕЛЬНЫЙ	ЧЕРТА ХАРАКТЕРА	ВЫШЕ
БЕЗДУХОВНОСТЬ	ЧЕРТА ХАРАКТЕРА	ВЫШЕ
БЕЗДУШНЫЙ, БЕССЕРДЕЧНЫЙ	ЧЕРТА ХАРАКТЕРА	ВЫШЕ
БЕЗЖАЛОСТНЫЙ, ЖЕСТОКИЙ	ЧЕРТА ХАРАКТЕРА	ВЫШЕ
БЕЗЗАВЕТНЫЙ	ЧЕРТА ХАРАКТЕРА	ВЫШЕ
БЕЗЗАСТЕНЧИВЫЙ	ЧЕРТА ХАРАКТЕРА	ВЫШЕ
БЕЗМОЗГЛЫЙ	ЧЕРТА ХАРАКТЕРА	ВЫШЕ
БЕЗНРАВСТВЕННЫЙ	ЧЕРТА ХАРАКТЕРА	ВЫШЕ
БЕЗОТКАЗНЫЙ (СТАРАТЕЛЬНЫЙ)	ЧЕРТА ХАРАКТЕРА	ВЫШЕ
БЕЗУЧАСТНЫЙ	ЧЕРТА ХАРАКТЕРА	ВЫШЕ
БЕЗЫНИЦИАТИВНЫЙ	ЧЕРТА ХАРАКТЕРА	ВЫШЕ
БЕРЕЖЛИВОСТЬ	ЧЕРТА ХАРАКТЕРА	ВЫШЕ
БЕРЕЖНЫЙ	ЧЕРТА ХАРАКТЕРА	ВЫШЕ
БЕСКОМПРОМИССНЫЙ	ЧЕРТА ХАРАКТЕРА	ВЫШЕ
БЕСКОРЫСТИЕ	ЧЕРТА ХАРАКТЕРА	ВЫШЕ
БЕСПРЕДЕЛ (БЕЗЗАКОНИЕ)	ЧЕРТА ХАРАКТЕРА	ВЫШЕ
БЕСПРИНЦИПНЫЙ	ЧЕРТА ХАРАКТЕРА	ВЫШЕ
БЕССЛОВЕСНЫЙ (МОЛЧАЛИВЫЙ, БЕЗРОПОТНЫЙ)	ЧЕРТА ХАРАКТЕРА	ВЫШЕ
БЕСТОЛКОВЫЙ (ГЛУПЫЙ)	ЧЕРТА ХАРАКТЕРА	ВЫШЕ
БЕСХИТРОСТНЫЙ	ЧЕРТА ХАРАКТЕРА	ВЫШЕ
БЕСЦЕРЕМОННЫЙ	ЧЕРТА ХАРАКТЕРА	ВЫШЕ
БЕСЧЕЛОВЕЧНЫЙ	ЧЕРТА ХАРАКТЕРА	ВЫШЕ
БЕСЧЕСТНЫЙ	ЧЕРТА ХАРАКТЕРА	ВЫШЕ
БЛАГОРОДНЫЙ (ВЫСОКОНРАВСТВЕННЫЙ, ЧЕСТНЫЙ)	ЧЕРТА ХАРАКТЕРА	ВЫШЕ
БЛИЗОРУКИЙ, НЕДАЛЬНОВИДНЫЙ	ЧЕРТА ХАРАКТЕРА	ВЫШЕ
БОДРЫЙ	ЧЕРТА ХАРАКТЕРА	ВЫШЕ
БОЕВОЙ (БОЙКИЙ, СМЕЛЫЙ)	ЧЕРТА ХАРАКТЕРА	ВЫШЕ
БОЙКИЙ (БЫСТРЫЙ, ЖИВОЙ)	ЧЕРТА ХАРАКТЕРА	ВЫШЕ
БОЙКИЙ (РАСТОРОПНЫЙ)	ЧЕРТА ХАРАКТЕРА	ВЫШЕ
БОЙЦОВСКИЙ ПО ХАРАКТЕРУ	ЧЕРТА ХАРАКТЕРА	ВЫШЕ
БОЛТЛИВЫЙ	ЧЕРТА ХАРАКТЕРА	ВЫШЕ
БОЯЗЛИВЫЙ	ЧЕРТА ХАРАКТЕРА	ВЫШЕ
БРАВУРНЫЙ	ЧЕРТА ХАРАКТЕРА	ВЫШЕ
БРАВЫЙ, МОЛОДЦЕВАТЫЙ	ЧЕРТА ХАРАКТЕРА	ВЫШЕ
БРЮЗГЛИВЫЙ	ЧЕРТА ХАРАКТЕРА	ВЫШЕ
БУЙНЫЙ (СВОЕНРАВНЫЙ, НЕПОКОРНЫЙ)	ЧЕРТА ХАРАКТЕРА	ВЫШЕ
ВДУМЧИВЫЙ	ЧЕРТА ХАРАКТЕРА	ВЫШЕ
ВЕЖЛИВЫЙ	ЧЕРТА ХАРАКТЕРА	ВЫШЕ
ВЕЗДЕСУЩИЙ, ВЕЗДЕ УСПЕВАЮЩИЙ	ЧЕРТА ХАРАКТЕРА	ВЫШЕ
ВЕЛИКОДУШНЫЙ	ЧЕРТА ХАРАКТЕРА	ВЫШЕ
ВЕРНОСТЬ В ЧУВСТВАХ	ЧЕРТА ХАРАКТЕРА	ВЫШЕ
ВЕРОТЕРПИМЫЙ	ЧЕРТА ХАРАКТЕРА	ВЫШЕ
ВЗБАЛМОШНЫЙ (СУМАСБРОДНЫЙ, НЕУРАВНОВЕШЕННЫЙ)	ЧЕРТА ХАРАКТЕРА	ВЫШЕ
ВЗДОРНЫЙ, СВАРЛИВЫЙ	ЧЕРТА ХАРАКТЕРА	ВЫШЕ
ВКРАДЧИВЫЙ	ЧЕРТА ХАРАКТЕРА	ВЫШЕ
ВЛАСТНЫЙ, АВТОРИТАРНЫЙ	ЧЕРТА ХАРАКТЕРА	ВЫШЕ
ВЛЮБЧИВЫЙ	ЧЕРТА ХАРАКТЕРА	ВЫШЕ
ВНИМАТЕЛЬНЫЙ, ЧУТКИЙ	ЧЕРТА ХАРАКТЕРА	ВЫШЕ
ВОЗБУДИМЫЙ, НЕРВНЫЙ	ЧЕРТА ХАРАКТЕРА	ВЫШЕ
ВОЗВЫШЕННЫЙ (БЛАГОРОДНЫЙ И ГЛУБОКИЙ)	ЧЕРТА ХАРАКТЕРА	ВЫШЕ
ВОИНСТВЕННЫЙ	ЧЕРТА ХАРАКТЕРА	ВЫШЕ
ВОИНСТВУЮЩИЙ	ЧЕРТА ХАРАКТЕРА	ВЫШЕ
ВОЛЕВОЙ, С СИЛОЙ ВОЛИ	ЧЕРТА ХАРАКТЕРА	ВЫШЕ
ВОРОВАТЫЙ (ОПАСЛИВЫЙ, ОСТОРОЖНЫЙ)	ЧЕРТА ХАРАКТЕРА	ВЫШЕ
ВОСПРИИМЧИВЫЙ	ЧЕРТА ХАРАКТЕРА	ВЫШЕ
ВОСТОРЖЕННЫЙ	ЧЕРТА ХАРАКТЕРА	ВЫШЕ
ВПЕЧАТЛИТЕЛЬНЫЙ	ЧЕРТА ХАРАКТЕРА	ВЫШЕ
ВРЕДНЫЙ ПО ХАРАКТЕРУ	ЧЕРТА ХАРАКТЕРА	ВЫШЕ
ВСПЫЛЬЧИВЫЙ, ЗАПАЛЬЧИВЫЙ	ЧЕРТА ХАРАКТЕРА	ВЫШЕ
ВУЛЬГАРНЫЙ (БЕЗВКУСНЫЙ)	ЧЕРТА ХАРАКТЕРА	ВЫШЕ
ВЪЕДЛИВЫЙ, ДОТОШНЫЙ	ЧЕРТА ХАРАКТЕРА	ВЫШЕ
ВЫЗЫВАЮЩИЙ	ЧЕРТА ХАРАКТЕРА	ВЫШЕ
ВЫНОСЛИВЫЙ	ЧЕРТА ХАРАКТЕРА	ВЫШЕ
ВЫСОКОПАРНЫЙ, НАПЫЩЕННЫЙ	ЧЕРТА ХАРАКТЕРА	ВЫШЕ
ВЯЛЫЙ (ЛИШЕННЫЙ БОДРОСТИ, ЭНЕРГИИ)	ЧЕРТА ХАРАКТЕРА	ВЫШЕ
ГАЗАВАТ	ЧЕРТА ХАРАКТЕРА	ВЫШЕ
ГАЛАНТНЫЙ	ЧЕРТА ХАРАКТЕРА	ВЫШЕ
ГЕРОИЧЕСКИЙ	ЧЕРТА ХАРАКТЕРА	ВЫШЕ
ГЛУПЫЙ, НЕДАЛЕКИЙ	ЧЕРТА ХАРАКТЕРА	ВЫШЕ
ГОСТЕПРИИМНЫЙ	ЧЕРТА ХАРАКТЕРА	ВЫШЕ
ГРУБЫЙ, РЕЗКИЙ	ЧЕРТА ХАРАКТЕРА	ВЫШЕ
ГРЯЗНЫЙ (БЕЗНРАВСТВЕННЫЙ)	ЧЕРТА ХАРАКТЕРА	ВЫШЕ
ГУМАНИЗМ (МИРОВОЗЗРЕНИЕ)	ЧЕРТА ХАРАКТЕРА	ВЫШЕ
ДАЛЬНОВИДНЫЙ (ПРЕДУСМОТРИТЕЛЬНЫЙ)	ЧЕРТА ХАРАКТЕРА	ВЫШЕ
ДЕЛИКАТНЫЙ, ТАКТИЧНЫЙ	ЧЕРТА ХАРАКТЕРА	ВЫШЕ
ДЕРЗКИЙ (НЕПОЧТИТЕЛЬНЫЙ)	ЧЕРТА ХАРАКТЕРА	ВЫШЕ
ДЕСПОТИЧЕСКИЙ (САМОВЛАСТНЫЙ)	ЧЕРТА ХАРАКТЕРА	ВЫШЕ
ДИСЦИПЛИНИРОВАННЫЙ	ЧЕРТА ХАРАКТЕРА	ВЫШЕ
ДОБЛЕСТНЫЙ (САМООТВЕРЖЕННЫЙ)	ЧЕРТА ХАРАКТЕРА	ВЫШЕ
ДОБРОДЕТЕЛЬ (ПОЛОЖИТЕЛЬНОЕ НРАВСТВЕННОЕ КАЧЕСТВО)	ЧЕРТА ХАРАКТЕРА	ВЫШЕ
ДОБРОДУШНЫЙ	ЧЕРТА ХАРАКТЕРА	ВЫШЕ
ДОБРОСОВЕСТНЫЙ	ЧЕРТА ХАРАКТЕРА	ВЫШЕ
ДОБРЫЙ, ДОБРОСЕРДЕЧНЫЙ	ЧЕРТА ХАРАКТЕРА	ВЫШЕ
ДОВЕРЧИВЫЙ	ЧЕРТА ХАРАКТЕРА	ВЫШЕ
ДОСТУПНЫЙ В ОБЩЕНИИ	ЧЕРТА ХАРАКТЕРА	ВЫШЕ
ДУШЕВНЫЙ (ИСКРЕННИЙ, ДРУЖЕЛЮБНЫЙ)	ЧЕРТА ХАРАКТЕРА	ВЫШЕ
ЖАДНЫЙ, ЖАДНО СТРЕМЯЩИЙСЯ	ЧЕРТА ХАРАКТЕРА	ВЫШЕ
ЖАЛОСТЛИВЫЙ	ЧЕРТА ХАРАКТЕРА	ВЫШЕ
ЖИВОЙ (АКТИВНЫЙ, ДЕЯТЕЛЬНЫЙ)	ЧЕРТА ХАРАКТЕРА	ВЫШЕ
ЖИВУЧИЙ (ЖИЗНЕСПОСОБНЫЙ, ВЫНОСЛИВЫЙ)	ЧЕРТА ХАРАКТЕРА	ВЫШЕ
ЖИЗНЕЛЮБИЕ	ЧЕРТА ХАРАКТЕРА	ВЫШЕ
ЖИЗНЕРАДОСТНЫЙ	ЧЕРТА ХАРАКТЕРА	ВЫШЕ
ЖИЗНЕУТВЕРЖДАЮЩИЙ	ЧЕРТА ХАРАКТЕРА	ВЫШЕ
ЗАБИТЫЙ (ЗАПУГАННЫЙ)	ЧЕРТА ХАРАКТЕРА	ВЫШЕ
ЗАБОТЛИВЫЙ	ЧЕРТА ХАРАКТЕРА	ВЫШЕ
ЗАБЫВЧИВЫЙ	ЧЕРТА ХАРАКТЕРА	ВЫШЕ
ЗАДИРИСТЫЙ	ЧЕРТА ХАРАКТЕРА	ВЫШЕ
ЗАДУМЧИВЫЙ	ЧЕРТА ХАРАКТЕРА	ВЫШЕ
ЗАКВАСКА (ЧЕРТЫ ХАРАКТЕРА)	ЧЕРТА ХАРАКТЕРА	ВЫШЕ
ЗАКОНОПОСЛУШНЫЙ	ЧЕРТА ХАРАКТЕРА	ВЫШЕ
ЗАМКНУТЫЙ, НЕОБЩИТЕЛЬНЫЙ	ЧЕРТА ХАРАКТЕРА	ВЫШЕ
ЗАПУГАННЫЙ	ЧЕРТА ХАРАКТЕРА	ВЫШЕ
ЗАСТЕНЧИВЫЙ	ЧЕРТА ХАРАКТЕРА	ВЫШЕ
ЗАТОРМОЖЕННЫЙ	ЧЕРТА ХАРАКТЕРА	ВЫШЕ
ЗАЯДЛЫЙ	ЧЕРТА ХАРАКТЕРА	ВЫШЕ
ЗДРАВЫЙ, ТРЕЗВЫЙ	ЧЕРТА ХАРАКТЕРА	ВЫШЕ
ЗЛОПАМЯТНЫЙ (НЕ ЗАБЫВАЮЩИЙ, НЕ ПРОЩ.ОБИД)	ЧЕРТА ХАРАКТЕРА	ВЫШЕ
ИЗБАЛОВАННЫЙ	ЧЕРТА ХАРАКТЕРА	ВЫШЕ
ИНТЕЛЛИГЕНТНОСТЬ (ЧЕРТА ХАРАКТЕРА)	ЧЕРТА ХАРАКТЕРА	ВЫШЕ
ИРОНИЧНЫЙ	ЧЕРТА ХАРАКТЕРА	ВЫШЕ
ИСПОЛНИТЕЛЬНЫЙ (СТАРАТЕЛЬНЫЙ)	ЧЕРТА ХАРАКТЕРА	ВЫШЕ
ИСПРАВНЫЙ (ДОБРОСОВЕСТНЫЙ)	ЧЕРТА ХАРАКТЕРА	ВЫШЕ
КАПРИЗНЫЙ	ЧЕРТА ХАРАКТЕРА	ВЫШЕ
КАТЕГОРИЧЕСКИЙ, НЕПРЕРЕКАЕМЫЙ	ЧЕРТА ХАРАКТЕРА	ВЫШЕ
КОРРЕКТНЫЙ (ВЕЖЛИВЫЙ, ТАКТИЧНЫЙ, УЧТИВЫЙ)	ЧЕРТА ХАРАКТЕРА	ВЫШЕ
КОРЫСТОЛЮБИЕ, СТЯЖАТЕЛЬСТВО	ЧЕРТА ХАРАКТЕРА	ВЫШЕ
КРОПОТЛИВЫЙ (УСЕРДНЫЙ)	ЧЕРТА ХАРАКТЕРА	ВЫШЕ
КРОТКИЙ, БЕЗОТВЕТНЫЙ	ЧЕРТА ХАРАКТЕРА	ВЫШЕ
КУРАЖ	ЧЕРТА ХАРАКТЕРА	ВЫШЕ
ЛАСКОВЫЙ	ЧЕРТА ХАРАКТЕРА	ВЫШЕ
ЛЕГКОВЕРНЫЙ	ЧЕРТА ХАРАКТЕРА	ВЫШЕ
ЛИБЕРАЛИЗМ (СНИСХОЖДЕНИЕ)	ЧЕРТА ХАРАКТЕРА	ВЫШЕ
ЛИДЕРСКИЕ КАЧЕСТВА	ЧЕРТА ХАРАКТЕРА	ВЫШЕ
ЛИНЧЕВАНИЕ (САМОСУД)	ЧЕРТА ХАРАКТЕРА	ВЫШЕ
ЛИЦЕМЕРНЫЙ	ЧЕРТА ХАРАКТЕРА	ВЫШЕ
ЛОВКИЙ, ПРОНЫРЛИВЫЙ	ЧЕРТА ХАРАКТЕРА	ВЫШЕ
ЛУКАВЫЙ (ИГРИВЫЙ, ДОБРОДУШ-НО ХИТРЫЙ)	ЧЕРТА ХАРАКТЕРА	ВЫШЕ
ЛЬСТИВЫЙ	ЧЕРТА ХАРАКТЕРА	ВЫШЕ
ЛЮБЕЗНЫЙ (ОБХОДИТЕЛЬНЫЙ)	ЧЕРТА ХАРАКТЕРА	ВЫШЕ
ЛЮБОЗНАТЕЛЬНОСТЬ, ПЫТЛИВОСТЬ	ЧЕРТА ХАРАКТЕРА	ВЫШЕ
МЕЖРЕЛИГИОЗНЫЙ КОНФЛИКТ	ЧЕРТА ХАРАКТЕРА	ВЫШЕ
МЕЛОЧНЫЙ ПО ХАРАКТЕРУ	ЧЕРТА ХАРАКТЕРА	ВЫШЕ
МЕРКАНТИЛЬНЫЙ (ИЗЛИШНЕ РАСЧЕТЛИВЫЙ)	ЧЕРТА ХАРАКТЕРА	ВЫШЕ
МЕЧТАТЕЛЬНЫЙ	ЧЕРТА ХАРАКТЕРА	ВЫШЕ
МИЛОСЕРДИЕ	ЧЕРТА ХАРАКТЕРА	ВЫШЕ
МИРОЛЮБИЕ	ЧЕРТА ХАРАКТЕРА	ВЫШЕ
МНИТЕЛЬНЫЙ	ЧЕРТА ХАРАКТЕРА	ВЫШЕ
МОЛЧАЛИВЫЙ, НЕРАЗГОВОРЧИВЫЙ	ЧЕРТА ХАРАКТЕРА	ВЫШЕ
МСТИТЕЛЬНОСТЬ	ЧЕРТА ХАРАКТЕРА	ВЫШЕ
МЯГКИЙ ПО ХАРАКТЕРУ	ЧЕРТА ХАРАКТЕРА	ВЫШЕ
НАВЯЗЧИВЫЙ (НАЗОЙЛИВЫЙ)	ЧЕРТА ХАРАКТЕРА	ВЫШЕ
НАГЛЫЙ	ЧЕРТА ХАРАКТЕРА	ВЫШЕ
НАДОЕДЛИВЫЙ	ЧЕРТА ХАРАКТЕРА	ВЫШЕ
НАЗОЙЛИВЫЙ	ЧЕРТА ХАРАКТЕРА	ВЫШЕ
НАИВНЫЙ	ЧЕРТА ХАРАКТЕРА	ВЫШЕ
НАИГРАННЫЙ	ЧЕРТА ХАРАКТЕРА	ВЫШЕ
НАПРЯЖЕННЫЙ, ПРИНУЖДЕННЫЙ	ЧЕРТА ХАРАКТЕРА	ВЫШЕ
НАСМЕШЛИВЫЙ	ЧЕРТА ХАРАКТЕРА	ВЫШЕ
НАСТОЙЧИВЫЙ	ЧЕРТА ХАРАКТЕРА	ВЫШЕ
НАСТОРОЖЕННЫЙ	ЧЕРТА ХАРАКТЕРА	ВЫШЕ
НАСТОЯТЕЛЬНЫЙ (ОЧЕНЬ НАСТОЙЧИВЫЙ)	ЧЕРТА ХАРАКТЕРА	ВЫШЕ
НАТУРАЛЬНЫЙ, ЕСТЕСТВЕННЫЙ, НЕПРИТВОРНЫЙ	ЧЕРТА ХАРАКТЕРА	ВЫШЕ
НАХОДЧИВЫЙ, ИЗОБРЕТАТЕЛЬНЫЙ	ЧЕРТА ХАРАКТЕРА	ВЫШЕ
НАЧАЛЬСТВЕННЫЙ	ЧЕРТА ХАРАКТЕРА	ВЫШЕ
НЕБРЕЖНЫЙ, НЕРАДИВЫЙ	ЧЕРТА ХАРАКТЕРА	ВЫШЕ
НЕВЕЖЕСТВЕННЫЙ	ЧЕРТА ХАРАКТЕРА	ВЫШЕ
НЕВЕЖЛИВЫЙ, НЕУЧТИВЫЙ	ЧЕРТА ХАРАКТЕРА	ВЫШЕ
НЕВЗЫСКАТЕЛЬНЫЙ, НЕТРЕБОВАТЕЛЬНЫЙ	ЧЕРТА ХАРАКТЕРА	ВЫШЕ
НЕВНИМАТЕЛЬНЫЙ (РАССЕЯННЫЙ)	ЧЕРТА ХАРАКТЕРА	ВЫШЕ
НЕВОЗМУТИМЫЙ (СПОКОЙНЫЙ)	ЧЕРТА ХАРАКТЕРА	ВЫШЕ
НЕВОСПИТАННЫЙ	ЧЕРТА ХАРАКТЕРА	ВЫШЕ
НЕДИСЦИПЛИНИРОВАННЫЙ	ЧЕРТА ХАРАКТЕРА	ВЫШЕ
НЕДОБРОСОВЕСТНЫЙ	ЧЕРТА ХАРАКТЕРА	ВЫШЕ
НЕДОВЕРЧИВЫЙ	ЧЕРТА ХАРАКТЕРА	ВЫШЕ
НЕЕСТЕСТВЕННЫЙ, НЕИСКРЕННИЙ	ЧЕРТА ХАРАКТЕРА	ВЫШЕ
НЕЛЮДИМЫЙ (НЕОБЩИТЕЛЬНЫЙ)	ЧЕРТА ХАРАКТЕРА	ВЫШЕ
НЕНАСЫТНЫЙ, ЖАДНЫЙ НА ЕДУ	ЧЕРТА ХАРАКТЕРА	ВЫШЕ
НЕПОДКУПНЫЙ	ЧЕРТА ХАРАКТЕРА	ВЫШЕ
НЕПОРОЧНЫЙ (НРАВСТВЕННО ЧИСТЫЙ)	ЧЕРТА ХАРАКТЕРА	ВЫШЕ
НЕПОСЕДЛИВЫЙ (ПОДВИЖНЫЙ)	ЧЕРТА ХАРАКТЕРА	ВЫШЕ
НЕПОСЛУШНЫЙ (ЧЕРТА ХАРАКТЕРА)	ЧЕРТА ХАРАКТЕРА	ВЫШЕ
НЕПОСРЕДСТВЕННЫЙ (ОТКРОВЕННЫЙ И НЕПРИНУЖДЕННЫЙ)	ЧЕРТА ХАРАКТЕРА	ВЫШЕ
НЕПРИМИРИМЫЙ	ЧЕРТА ХАРАКТЕРА	ВЫШЕ
НЕПРИНУЖДЕННЫЙ	ЧЕРТА ХАРАКТЕРА	ВЫШЕ
НЕПРИХОТЛИВЫЙ, НЕПРИТЯЗАТЕЛЬНЫЙ	ЧЕРТА ХАРАКТЕРА	ВЫШЕ
НЕРАЗБОРЧИВЫЙ (НЕТРЕБОВАТЕЛЬНЫЙ)	ЧЕРТА ХАРАКТЕРА	ВЫШЕ
НЕРЕШИТЕЛЬНЫЙ	ЧЕРТА ХАРАКТЕРА	ВЫШЕ
НЕРЯШЛИВЫЙ, НЕОПРЯТНЫЙ	ЧЕРТА ХАРАКТЕРА	ВЫШЕ
НЕСГОВОРЧИВЫЙ, НЕПОКЛАДИСТЫЙ	ЧЕРТА ХАРАКТЕРА	ВЫШЕ
НЕСОКРУШИМЫЙ	ЧЕРТА ХАРАКТЕРА	ВЫШЕ
НЕТЕРПЕЛИВЫЙ	ЧЕРТА ХАРАКТЕРА	ВЫШЕ
НЕТЕРПИМОСТЬ К ЛЮДЯМ	ЧЕРТА ХАРАКТЕРА	ВЫШЕ
НЕУВЕРЕННЫЙ В СЕБЕ	ЧЕРТА ХАРАКТЕРА	ВЫШЕ
НЕУГОМОННЫЙ	ЧЕРТА ХАРАКТЕРА	ВЫШЕ
НЕУМОЛИМЫЙ	ЧЕРТА ХАРАКТЕРА	ВЫШЕ
НЕУТОМИМЫЙ	ЧЕРТА ХАРАКТЕРА	ВЫШЕ
НИЗКИЙ, ПОДЛЫЙ	ЧЕРТА ХАРАКТЕРА	ВЫШЕ
НУДНЫЙ	ЧЕРТА ХАРАКТЕРА	ВЫШЕ
ОБИДЧИВЫЙ	ЧЕРТА ХАРАКТЕРА	ВЫШЕ
ОБОРОТЛИВЫЙ (ПРАКТИЧНЫЙ)	ЧЕРТА ХАРАКТЕРА	ВЫШЕ
ОБОСТРЕННЫЙ (НАПРЯЖЕННЫЙ, НЕПРИЯЗНЕННЫЙ)	ЧЕРТА ХАРАКТЕРА	ВЫШЕ
ОБХОДИТЕЛЬНЫЙ	ЧЕРТА ХАРАКТЕРА	ВЫШЕ
ОБЩИТЕЛЬНЫЙ	ЧЕРТА ХАРАКТЕРА	ВЫШЕ
ОБЯЗАТЕЛЬНЫЙ (ОТВЕТСТВЕННЫЙ)	ЧЕРТА ХАРАКТЕРА	ВЫШЕ
ОДЕРЖИМЫЙ (УВЛЕЧЕННЫЙ)	ЧЕРТА ХАРАКТЕРА	ВЫШЕ
ОЖЕСТОЧЕНИЕ (УПОРСТВО)	ЧЕРТА ХАРАКТЕРА	ВЫШЕ
ОПАСЛИВЫЙ	ЧЕРТА ХАРАКТЕРА	ВЫШЕ
ОПРЯТНЫЙ (ЧЕРТА ХАРАКТЕРА)	ЧЕРТА ХАРАКТЕРА	ВЫШЕ
ОРТОДОКСАЛЬНЫЙ	ЧЕРТА ХАРАКТЕРА	ВЫШЕ
ОСТОРОЖНЫЙ, ОСМОТРИТЕЛЬНЫЙ	ЧЕРТА ХАРАКТЕРА	ВЫШЕ
ОТВЕТСТВЕННЫЙ ПО ХАРАКТЕРУ	ЧЕРТА ХАРАКТЕРА	ВЫШЕ
ОТЕЧЕСКИЙ	ЧЕРТА ХАРАКТЕРА	ВЫШЕ
ОТЗЫВЧИВЫЙ	ЧЕРТА ХАРАКТЕРА	ВЫШЕ
ОТКРЫТЫЙ (ИСКРЕННИЙ, ОТКРОВЕННЫЙ)	ЧЕРТА ХАРАКТЕРА	ВЫШЕ
ПАССИОНАРНЫЙ (АКТИВНЫЙ)	ЧЕРТА ХАРАКТЕРА	ВЫШЕ
ПЕДАНТИЧНЫЙ (СТРОГИЙ В ВЫПОЛНЕНИИ ВСЕХ ТРЕБОВАНИЙ)	ЧЕРТА ХАРАКТЕРА	ВЫШЕ
ПОДВИЖНЫЙ (ЖИВОЙ, ЛЕГКИЙ)	ЧЕРТА ХАРАКТЕРА	ВЫШЕ
ПОДОЗРИТЕЛЬНЫЙ (НЕДОВЕРЧИВЫЙ)	ЧЕРТА ХАРАКТЕРА	ВЫШЕ
ПОДТЯНУТЫЙ, ПОДОБРАННЫЙ	ЧЕРТА ХАРАКТЕРА	ВЫШЕ
ПОКАЗНОЙ (ПРИТВОРНЫЙ)	ЧЕРТА ХАРАКТЕРА	ВЫШЕ
ПОКЛАДИСТЫЙ	ЧЕРТА ХАРАКТЕРА	ВЫШЕ
ПОКОРНЫЙ (ПОСЛУШНЫЙ)	ЧЕРТА ХАРАКТЕРА	ВЫШЕ
ПОЛИТИЧЕСКИЙ ВОЛЮНТАРИЗМ	ЧЕРТА ХАРАКТЕРА	ВЫШЕ
ПОЛИТКОРРЕКТНОСТЬ	ЧЕРТА ХАРАКТЕРА	ВЫШЕ
ПОЛНОКРОВНЫЙ (ДЕЯТЕЛЬНЫЙ)	ЧЕРТА ХАРАКТЕРА	ВЫШЕ
ПОНЯТЛИВЫЙ	ЧЕРТА ХАРАКТЕРА	ВЫШЕ
ПОРОЧНЫЙ (БЕЗНРАВСТВЕННЫЙ)	ЧЕРТА ХАРАКТЕРА	ВЫШЕ
ПОРЫВИСТЫЙ, ИМПУЛЬСИВНЫЙ (ДЕЙСТВУЮЩИЙ ПОРЫВАМИ)	ЧЕРТА ХАРАКТЕРА	ВЫШЕ
ПОРЯДОЧНЫЙ, ДОБРОПОРЯДОЧНЫЙ	ЧЕРТА ХАРАКТЕРА	ВЫШЕ
ПОСЛУШНЫЙ (ЧЕРТА ХАРАКТЕРА)	ЧЕРТА ХАРАКТЕРА	ВЫШЕ
ПОЭТИЧЕСКИ НАСТРОЕННЫЙ	ЧЕРТА ХАРАКТЕРА	ВЫШЕ
ПРАВЕДНЫЙ (БЛАГОЧЕСТИВЫЙ, БЕЗГРЕШНЫЙ)	ЧЕРТА ХАРАКТЕРА	ВЫШЕ
ПРАКТИЧНЫЙ В ДЕЛАХ	ЧЕРТА ХАРАКТЕРА	ВЫШЕ
ПРЕДПРИИМЧИВЫЙ	ЧЕРТА ХАРАКТЕРА	ВЫШЕ
ПРЕДУПРЕДИТЕЛЬНЫЙ (ВНИМАТЕЛЬНЫЙ, ЛЮБЕЗНЫЙ)	ЧЕРТА ХАРАКТЕРА	ВЫШЕ
ПРЕДУСМОТРИТЕЛЬНЫЙ	ЧЕРТА ХАРАКТЕРА	ВЫШЕ
ПРИВЕТЛИВЫЙ	ЧЕРТА ХАРАКТЕРА	ВЫШЕ
ПРИДИРЧИВЫЙ	ЧЕРТА ХАРАКТЕРА	ВЫШЕ
ПРИНЦИПИАЛЬНЫЙ, С ТВЕРДЫМИ ПРИНЦИПАМИ	ЧЕРТА ХАРАКТЕРА	ВЫШЕ
ПРИПОДНЯТОЕ НАСТРОЕНИЕ	ЧЕРТА ХАРАКТЕРА	ВЫШЕ
ПРИТВОРНЫЙ	ЧЕРТА ХАРАКТЕРА	ВЫШЕ
ПРИТОРНЫЙ, ИЗЛИШНЕ ЛЮБЕЗНЫЙ	ЧЕРТА ХАРАКТЕРА	ВЫШЕ
ПРОБИВНОЙ, НАПОРИСТЫЙ	ЧЕРТА ХАРАКТЕРА	ВЫШЕ
ПРОВИНЦИАЛЬНЫЙ, МЕСТЕЧКОВЫЙ	ЧЕРТА ХАРАКТЕРА	ВЫШЕ
ПРОДАЖНЫЙ (БЕСПРИНЦИПНЫЙ)	ЧЕРТА ХАРАКТЕРА	ВЫШЕ
ПРОИЗВОЛ (СВОЕВОЛИЕ, САМОВЛАСТИЕ)	ЧЕРТА ХАРАКТЕРА	ВЫШЕ
ПРЫТКИЙ (ПОДВИЖНЫЙ, ПРОВОРНЫЙ)	ЧЕРТА ХАРАКТЕРА	ВЫШЕ
ПРЯМОЛИНЕЙНЫЙ (ОТКРОВЕННЫЙ)	ЧЕРТА ХАРАКТЕРА	ВЫШЕ
ПУСТОГОЛОВЫЙ	ЧЕРТА ХАРАКТЕРА	ВЫШЕ
ПУСТОГОЛОВЫЙ (ГЛУПЫЙ, НЕСЕРЬЕЗНЫЙ)	ЧЕРТА ХАРАКТЕРА	ВЫШЕ
РАБСКИЙ (ПОКОРНЫЙ)	ЧЕРТА ХАРАКТЕРА	ВЫШЕ
РАДИКАЛЬНЫЙ (РЕШИТЕЛЬНЫЙ, КОРЕННОЙ)	ЧЕРТА ХАРАКТЕРА	ВЫШЕ
РАДУШНЫЙ	ЧЕРТА ХАРАКТЕРА	ВЫШЕ
РАЗБОРЧИВЫЙ, ПРИВЕРЕДЛИВЫЙ	ЧЕРТА ХАРАКТЕРА	ВЫШЕ
РАЗВЯЗНЫЙ	ЧЕРТА ХАРАКТЕРА	ВЫШЕ
РАЗГОВОРЧИВЫЙ	ЧЕРТА ХАРАКТЕРА	ВЫШЕ
РАЗДРАЖИТЕЛЬНЫЙ (БЫСТРО РАЗДРАЖАЮЩИЙСЯ)	ЧЕРТА ХАРАКТЕРА	ВЫШЕ
РАЗНУЗДАННЫЙ	ЧЕРТА ХАРАКТЕРА	ВЫШЕ
РАЗУМНЫЙ, ЗДРАВОСМЫСЛЯЩИЙ	ЧЕРТА ХАРАКТЕРА	ВЫШЕ
РАНИМЫЙ	ЧЕРТА ХАРАКТЕРА	ВЫШЕ
РАСКОВАННЫЙ В ОБЩЕНИИ	ЧЕРТА ХАРАКТЕРА	ВЫШЕ
РАСПУЩЕННЫЙ (НЕДИСЦИПЛИНИРОВАННЫЙ, СВОЕВОЛЬНЫЙ)	ЧЕРТА ХАРАКТЕРА	ВЫШЕ
РАССЕЯННЫЙ (ЧЕРТА ХАРАКТЕРА)	ЧЕРТА ХАРАКТЕРА	ВЫШЕ
РАССУДИТЕЛЬНЫЙ (БЛАГОРАЗУМНЫЙ)	ЧЕРТА ХАРАКТЕРА	ВЫШЕ
РАСЧЕТЛИВЫЙ	ЧЕРТА ХАРАКТЕРА	ВЫШЕ
РЕАЛИСТИЧНЫЙ (ТРЕЗВО-ПРАКТИЧЕСКИЙ)	ЧЕРТА ХАРАКТЕРА	ВЫШЕ
РЕЗВЫЙ (ПОДВИЖНЫЙ И ВЕСЕЛЫЙ)	ЧЕРТА ХАРАКТЕРА	ВЫШЕ
РЕЛИГИОЗНАЯ НЕТЕРПИМОСТЬ	ЧЕРТА ХАРАКТЕРА	ВЫШЕ
РЕШИТЕЛЬНЫЙ В ПОСТУПКАХ	ЧЕРТА ХАРАКТЕРА	ВЫШЕ
РОБКИЙ	ЧЕРТА ХАРАКТЕРА	ВЫШЕ
РОМАНТИЧНЫЙ	ЧЕРТА ХАРАКТЕРА	ВЫШЕ
РЫЦАРСКИЙ (БЛАГОРОДНЫЙ И САМООТВЕРЖЕННЫЙ)	ЧЕРТА ХАРАКТЕРА	ВЫШЕ
РЬЯНЫЙ	ЧЕРТА ХАРАКТЕРА	ВЫШЕ
САМООТВЕРЖЕННЫЙ	ЧЕРТА ХАРАКТЕРА	ВЫШЕ
САМОСТОЯТЕЛЬНЫЙ (РЕШИТЕЛЬНЫЙ)	ЧЕРТА ХАРАКТЕРА	ВЫШЕ
САМОСУД	ЧЕРТА ХАРАКТЕРА	ВЫШЕ
САМОУВЕРЕННОСТЬ	ЧЕРТА ХАРАКТЕРА	ВЫШЕ
САРКАСТИЧЕСКИЙ	ЧЕРТА ХАРАКТЕРА	ВЫШЕ
СВЕЖИЙ, НЕ УСТАВШИЙ	ЧЕРТА ХАРАКТЕРА	ВЫШЕ
СВИРЕПЫЙ (БЕЗЖАЛОСТНЫЙ)	ЧЕРТА ХАРАКТЕРА	ВЫШЕ
СВОБОДОЛЮБИЕ	ЧЕРТА ХАРАКТЕРА	ВЫШЕ
СВОЕВОЛИЕ	ЧЕРТА ХАРАКТЕРА	ВЫШЕ
СВОЕНРАВНЫЙ	ЧЕРТА ХАРАКТЕРА	ВЫШЕ
СГОВОРЧИВЫЙ, УСТУПЧИВЫЙ	ЧЕРТА ХАРАКТЕРА	ВЫШЕ
СДЕРЖАННОСТЬ В ПОВЕДЕНИИ	ЧЕРТА ХАРАКТЕРА	ВЫШЕ
СЕРЬЕЗНЫЙ, СЕРЬЕЗНО НАСТРОЕННЫЙ	ЧЕРТА ХАРАКТЕРА	ВЫШЕ
СКАНДАЛЬНЫЙ ПО ХАРАКТЕРУ	ЧЕРТА ХАРАКТЕРА	ВЫШЕ
СКЕПТИЧЕСКИЙ (КРИТИЧЕСКИ-НЕДОВЕРЧИВЫЙ)	ЧЕРТА ХАРАКТЕРА	ВЫШЕ
СКОВАННЫЙ, ЗАЖАТЫЙ	ЧЕРТА ХАРАКТЕРА	ВЫШЕ
СКРОМНЫЙ, НЕХВАСТЛИВЫЙ	ЧЕРТА ХАРАКТЕРА	ВЫШЕ
СКРУПУЛЕЗНЫЙ (СТАРАТЕЛЬНЫЙ,УСЕРДНЫЙ)	ЧЕРТА ХАРАКТЕРА	ВЫШЕ
СКРЫТНЫЙ	ЧЕРТА ХАРАКТЕРА	ВЫШЕ
СКУПОЙ НА ПРОЯВЛЕНИЕ ЧУВСТВ	ЧЕРТА ХАРАКТЕРА	ВЫШЕ
СКУПОСТЬ, ЖАДНОСТЬ	ЧЕРТА ХАРАКТЕРА	ВЫШЕ
СЛАБОВОЛЬНЫЙ	ЧЕРТА ХАРАКТЕРА	ВЫШЕ
СЛЕПОЙ, СЛЕПО ИСПОЛНЯЮЩИЙ	ЧЕРТА ХАРАКТЕРА	ВЫШЕ
СМЕЛЫЙ (НЕПРИЛИЧНЫЙ)	ЧЕРТА ХАРАКТЕРА	ВЫШЕ
СМИРНЫЙ, ТИХИЙ	ЧЕРТА ХАРАКТЕРА	ВЫШЕ
СОВЕСТЛИВЫЙ	ЧЕРТА ХАРАКТЕРА	ВЫШЕ
СОЗЕРЦАТЕЛЬНЫЙ	ЧЕРТА ХАРАКТЕРА	ВЫШЕ
СОНЛИВОСТЬ	ЧЕРТА ХАРАКТЕРА	ВЫШЕ
СООБРАЗИТЕЛЬНЫЙ	ЧЕРТА ХАРАКТЕРА	ВЫШЕ
СТАРАТЕЛЬНЫЙ	ЧЕРТА ХАРАКТЕРА	ВЫШЕ
СТЕПЕННЫЙ (РАССУДИТЕЛЬНО-СЕРЬЕЗНЫЙ, ВАЖНЫЙ)	ЧЕРТА ХАРАКТЕРА	ВЫШЕ
СТРОГИЙ (ТРЕБОВАТЕЛЬНЫЙ)	ЧЕРТА ХАРАКТЕРА	ВЫШЕ
СУМАСБРОДНЫЙ (БЕЗРАССУДНЫЙ, КАПРИЗНЫЙ)	ЧЕРТА ХАРАКТЕРА	ВЫШЕ
СУПРУЖЕСКАЯ ВЕРНОСТЬ	ЧЕРТА ХАРАКТЕРА	ВЫШЕ
ТВЕРДОСТЬ, СТОЙКОСТЬ, НЕПОКОЛЕБИМОСТЬ	ЧЕРТА ХАРАКТЕРА	ВЫШЕ
ТЕАТРАЛЬНЫЙ (НЕЕСТЕСТВЕННЫЙ, ПОКАЗНОЙ)	ЧЕРТА ХАРАКТЕРА	ВЫШЕ
ТЕМПЕРАМЕНТНЫЙ (ЖИВОЙ, ЭНЕРГИЧНЫЙ)	ЧЕРТА ХАРАКТЕРА	ВЫШЕ
ТЕРПЕНИЕ (СПОСОБНОСТЬ ТЕРПЕТЬ)	ЧЕРТА ХАРАКТЕРА	ВЫШЕ
ТЕРПИМОСТЬ К ЛЮДЯМ	ЧЕРТА ХАРАКТЕРА	ВЫШЕ
ТОЛКОВЫЙ (ПОНЯТЛИВЫЙ)	ЧЕРТА ХАРАКТЕРА	ВЫШЕ
ТРЕБОВАТЕЛЬНЫЙ, ВЗЫСКАТЕЛЬНЫЙ	ЧЕРТА ХАРАКТЕРА	ВЫШЕ
ТРУДНЫЙ ПО ХАРАКТЕРУ	ЧЕРТА ХАРАКТЕРА	ВЫШЕ
ТРУДОЛЮБИЕ, РАБОТОСПОСОБНОСТЬ	ЧЕРТА ХАРАКТЕРА	ВЫШЕ
ТРУСОСТЬ	ЧЕРТА ХАРАКТЕРА	ВЫШЕ
ТУПОЙ (ГЛУПЫЙ)	ЧЕРТА ХАРАКТЕРА	ВЫШЕ
УБЕЖДЕННЫЙ В СВОИХ ВЗГЛЯДАХ	ЧЕРТА ХАРАКТЕРА	ВЫШЕ
УВЕРЕННОСТЬ В СЕБЕ	ЧЕРТА ХАРАКТЕРА	ВЫШЕ
УВЕРЕННЫЙ	ЧЕРТА ХАРАКТЕРА	ВЫШЕ
УВЕРТЛИВЫЙ	ЧЕРТА ХАРАКТЕРА	ВЫШЕ
УВЛЕЧЕННЫЙ	ЧЕРТА ХАРАКТЕРА	ВЫШЕ
УГЛУБЛЕННЫЙ (СЕРЬЕЗНЫЙ, ОСНОВАТЕЛЬНЫЙ)	ЧЕРТА ХАРАКТЕРА	ВЫШЕ
УЖИВЧИВЫЙ	ЧЕРТА ХАРАКТЕРА	ВЫШЕ
УЛЫБЧИВЫЙ (ЧАСТО УЛЫБАЮЩИЙСЯ)	ЧЕРТА ХАРАКТЕРА	ВЫШЕ
УЛЬТИМАТИВНЫЙ (КАТЕГОРИЧЕСКИЙ)	ЧЕРТА ХАРАКТЕРА	ВЫШЕ
УПОРСТВО В ДОСТИЖЕНИИ ЦЕЛИ	ЧЕРТА ХАРАКТЕРА	ВЫШЕ
УПРЯМЫЙ (НЕУСТУПЧИВЫЙ)	ЧЕРТА ХАРАКТЕРА	ВЫШЕ
УРАВНОВЕШЕННЫЙ ПО ХАРАКТЕРУ	ЧЕРТА ХАРАКТЕРА	ВЫШЕ
УСЕРДНЫЙ	ЧЕРТА ХАРАКТЕРА	ВЫШЕ
УСИДЧИВЫЙ	ЧЕРТА ХАРАКТЕРА	ВЫШЕ
УСЛУЖЛИВЫЙ	ЧЕРТА ХАРАКТЕРА	ВЫШЕ
УЧТИВЫЙ	ЧЕРТА ХАРАКТЕРА	ВЫШЕ
ФИЛОСОФСКИЙ (РАССУДИТЕЛЬНЫЙ И СПОКОЙНЫЙ)	ЧЕРТА ХАРАКТЕРА	ВЫШЕ
ФЛЕГМАТИЧНЫЙ (ВЯЛЫЙ, РАВНОДУШНЫЙ)	ЧЕРТА ХАРАКТЕРА	ВЫШЕ
ХАЛАТНЫЙ (НЕБРЕЖНЫЙ И НЕДОБРОСОВЕСТНЫЙ)	ЧЕРТА ХАРАКТЕРА	ВЫШЕ
ХАРИЗМА	ЧЕРТА ХАРАКТЕРА	ВЫШЕ
ХВАСТЛИВЫЙ, НЕСКРОМНЫЙ	ЧЕРТА ХАРАКТЕРА	ВЫШЕ
ХИТРЫЙ, ХИТРОУМНЫЙ	ЧЕРТА ХАРАКТЕРА	ВЫШЕ
ХОЗЯЙСТВЕННЫЙ	ЧЕРТА ХАРАКТЕРА	ВЫШЕ
ЦЕЛЕУСТРЕМЛЕННОСТЬ	ЧЕРТА ХАРАКТЕРА	ВЫШЕ
ЦЕПКИЙ (ОЧЕНЬ УПОРНЫЙ)	ЧЕРТА ХАРАКТЕРА	ВЫШЕ
ЦИНИЧНЫЙ	ЧЕРТА ХАРАКТЕРА	ВЫШЕ
ЧЕЛОВЕЧНЫЙ	ЧЕРТА ХАРАКТЕРА	ВЫШЕ
ЧЕРТА ХАРАКТЕРА	ЧЕРТА ХАРАКТЕРА	ВЫШЕ
ЧЕСТНЫЙ, ПРАВДИВЫЙ	ЧЕРТА ХАРАКТЕРА	ВЫШЕ
ЧЕСТОЛЮБИЕ	ЧЕРТА ХАРАКТЕРА	ВЫШЕ
ЧИСТОПЛОТНЫЙ (ОПРЯТНЫЙ)	ЧЕРТА ХАРАКТЕРА	ВЫШЕ
ЧИСТОПЛОТНЫЙ (ПОРЯДОЧНЫЙ)	ЧЕРТА ХАРАКТЕРА	ВЫШЕ
ЧИСТОСЕРДЕЧНЫЙ, ИСКРЕННИЙ, ОТКРОВЕННЫЙ	ЧЕРТА ХАРАКТЕРА	ВЫШЕ
ЧОПОРНЫЙ, ЦЕРЕМОННЫЙ	ЧЕРТА ХАРАКТЕРА	ВЫШЕ
ЧУВСТВИТЕЛЬНЫЙ, СЕНТИМЕНТАЛЬНЫЙ	ЧЕРТА ХАРАКТЕРА	ВЫШЕ
ЧУТКИЙ (ОТЗЫВЧИВЫЙ)	ЧЕРТА ХАРАКТЕРА	ВЫШЕ
ШЕЛКОВЫЙ (ПОСЛУШНЫЙ)	ЧЕРТА ХАРАКТЕРА	ВЫШЕ
ШУМЛИВЫЙ, ШУМНЫЙ	ЧЕРТА ХАРАКТЕРА	ВЫШЕ
ЩЕДРЫЙ, НЕЖАДНЫЙ	ЧЕРТА ХАРАКТЕРА	ВЫШЕ
ЩЕПЕТИЛЬНЫЙ (ПОСЛЕДОВАТЕЛЬНЫЙ И ПРИНЦИПИАЛЬНЫЙ)	ЧЕРТА ХАРАКТЕРА	ВЫШЕ
ЭКОНОМНЫЙ (БЕРЕЖЛИВО РАСХОДУЮЩИЙ)	ЧЕРТА ХАРАКТЕРА	ВЫШЕ
ЭКСТРАВАГАНТНЫЙ	ЧЕРТА ХАРАКТЕРА	ВЫШЕ
ЭКСЦЕНТРИЧНЫЙ (ВЫЗЫВАЮЩИЙ)	ЧЕРТА ХАРАКТЕРА	ВЫШЕ
ЭМОЦИОНАЛЬНЫЙ, ПОДВЕРЖЕННЫЙ ЭМОЦИЯМ	ЧЕРТА ХАРАКТЕРА	ВЫШЕ
ЭНЕРГИЧНЫЙ	ЧЕРТА ХАРАКТЕРА	ВЫШЕ
ЯЗВИТЕЛЬНЫЙ	ЧЕРТА ХАРАКТЕРА	ВЫШЕ